TGAATGTATTACGTTTGCTAGAAG -> GAATGTATTACGTTTGCTAGAAGC
AATCCATACGCGATACCTAGGCTG -> ATCCATACGCGATACCTAGGCTGA
TCATCCGTTGCCAAGCTTGATTTC -> CATCCGTTGCCAAGCTTGATTTCG
CCCCTCTTGAGCGGGCTCCATTGC -> CCCTCTTGAGCGGGCTCCATTGCA
TGGTCCGTGGTTGCAACGCCCCTC -> GGTCCGTGGTTGCAACGCCCCTCT
GATGTCACACGTGGATACCTGCTC -> ATGTCACACGTGGATACCTGCTCC
CTATGGGATGTATCGATACCACAT -> TATGGGATGTATCGATACCACATG
AGATTGGGGCGCTCCCCCTTGAAG -> GATTGGGGCGCTCCCCCTTGAAGA
CACTAGACCGCTAATCGCGCGAAC -> ACTAGACCGCTAATCGCGCGAACT
AAAGTTAACTGGGCGAGCTGCGAG -> AAGTTAACTGGGCGAGCTGCGAGG
GAGACTAACAGTTGTTTAGATATA -> AGACTAACAGTTGTTTAGATATAG
CATTAATATCCTCTTTACGTCACA -> ATTAATATCCTCTTTACGTCACAT
GAGTCGCGAGGAATACCTCATCGG -> AGTCGCGAGGAATACCTCATCGGG
TCCCGAGTGTGTTAGACCGGTTCC -> CCCGAGTGTGTTAGACCGGTTCCG
GTACATTTCAGCGTCAGTATCCTA -> TACATTTCAGCGTCAGTATCCTAT
TACCTTCGTGGTCCGAGCCTTGAG -> ACCTTCGTGGTCCGAGCCTTGAGG
AGTTGTTTAGATATAGAAACTCAG -> GTTGTTTAGATATAGAAACTCAGC
ACTCCTATAATAAAAATCCTTTGT -> CTCCTATAATAAAAATCCTTTGTA
TTATCCCAATCTTGTGCTTAAATC -> TATCCCAATCTTGTGCTTAAATCA
CTGTGACGATCCTGCCCAGATTGG -> TGTGACGATCCTGCCCAGATTGGG
CTTCGTGGTCCGAGCCTTGAGGTG -> TTCGTGGTCCGAGCCTTGAGGTGC
AATTGTGCCTTTAGGCTGTTGACA -> ATTGTGCCTTTAGGCTGTTGACAA
GCAAGAACAATGTGTTAGTGGAAG -> CAAGAACAATGTGTTAGTGGAAGG
TTGGTCCGTGGTTGCAACGCCCCT -> TGGTCCGTGGTTGCAACGCCCCTC
GTGTGTTAGACCGGTTCCGGAAAC -> TGTGTTAGACCGGTTCCGGAAACT
AGAGTCGCGAGGAATACCTCATCG -> GAGTCGCGAGGAATACCTCATCGG
AGATCATTAATATCCTCTTTACGT -> GATCATTAATATCCTCTTTACGTC
AAAATAGATGGGGCCTAGTGGTCT -> AAATAGATGGGGCCTAGTGGTCTA
AGCGTCATAGACCGCACCATTTGC -> GCGTCATAGACCGCACCATTTGCA
ATGTAGACATTTTAGACTATGCTT -> TGTAGACATTTTAGACTATGCTTT
CCACTTAATCGTCCCTATAGCCCT -> CACTTAATCGTCCCTATAGCCCTG
GATACCTGCTCCCTTGGCTTATCG -> ATACCTGCTCCCTTGGCTTATCGG
CATGAACATACGCCCCTCCCTTGC -> ATGAACATACGCCCCTCCCTTGCG
CGTTGTTATGAATCGACGCTCACA -> GTTGTTATGAATCGACGCTCACAC
ACTATCGGGCACCAGCAGTTGTCT -> CTATCGGGCACCAGCAGTTGTCTG
CTGTCACGTAATTTCCAGCCGAAT -> TGTCACGTAATTTCCAGCCGAATC
GCGTGCAGCGGAGCTGGGAACGAC -> CGTGCAGCGGAGCTGGGAACGACG
CTGAACGGCCCAGATATAGTGGTC -> TGAACGGCCCAGATATAGTGGTCC
AAGCCATAGAGTTTAAGATCTGAG -> AGCCATAGAGTTTAAGATCTGAGT
CAGCCGAATCTCCGTGGACGACGC -> AGCCGAATCTCCGTGGACGACGCG
TGTGTGGTGATGCCCCTTCCACTT -> GTGTGGTGATGCCCCTTCCACTTA
GATTCCCTAGACTACGTCGACTGT -> ATTCCCTAGACTACGTCGACTGTA
AGTTATCAGGTCCATGCAGAATCC -> GTTATCAGGTCCATGCAGAATCCA
GTGTGCATAGGACCAGTACGTATC -> TGTGCATAGGACCAGTACGTATCT
ATTAATAGTACCCGAGAGGATAAT -> TTAATAGTACCCGAGAGGATAATT
TTGCAACGCCCCTCTTGAGCGGGC -> TGCAACGCCCCTCTTGAGCGGGCT
AAACCGCAATTGGTCCGTGGTTGC -> AACCGCAATTGGTCCGTGGTTGCA
TGAGAGAGCGTCATAGACCGCACC -> GAGAGAGCGTCATAGACCGCACCA
GATTCTGCATATTGCCATAATTTA -> ATTCTGCATATTGCCATAATTTAC
TGACGCACTAATATGAGACTAACA -> GACGCACTAATATGAGACTAACAG
GGAAACTAGACTAGATCATTAATA -> GAAACTAGACTAGATCATTAATAT
CAATGGCAAGCTACATTGTGTGGT -> AATGGCAAGCTACATTGTGTGGTG
ACAATCTGCAGTGTCGCCAGACCA -> CAATCTGCAGTGTCGCCAGACCAA
CACGTGGATACCTGCTCCCTTGGC -> ACGTGGATACCTGCTCCCTTGGCT
CCGAGTCAGTCGGTAACACATACT -> CGAGTCAGTCGGTAACACATACTC
TTAGTGGAAGGGGTGTCTCCCCGA -> TAGTGGAAGGGGTGTCTCCCCGAT
GTATCGATACCACATGGCGGTCAA -> TATCGATACCACATGGCGGTCAAC
GTCAACGTACGCAGGGGTTGCCGA -> TCAACGTACGCAGGGGTTGCCGAG
AAAATCCTTTGTATCAAAAAATAG -> AAATCCTTTGTATCAAAAAATAGA
GTTATCAGGTCCATGCAGAATCCA -> TTATCAGGTCCATGCAGAATCCAT
TCTTGAGCGGGCTCCATTGCACCG -> CTTGAGCGGGCTCCATTGCACCGC
CCGTGGTTGCAACGCCCCTCTTGA -> CGTGGTTGCAACGCCCCTCTTGAG
TAGGAACGTCCTCGAGAGACCAAA -> AGGAACGTCCTCGAGAGACCAAAC
CTCCCTTGCGGGATGTCACACGTG -> TCCCTTGCGGGATGTCACACGTGG
GCTGTGCGATGTAGACATTTTAGA -> CTGTGCGATGTAGACATTTTAGAC
TTTATAAAGGGCTACCTGGCAACA -> TTATAAAGGGCTACCTGGCAACAG
GCGGATTCCCTAGACTACGTCGAC -> CGGATTCCCTAGACTACGTCGACT
ACCACATGGCGGTCAACGTACGCA -> CCACATGGCGGTCAACGTACGCAG
CCAGAGCAGTGCCCCCCAATAGGC -> CAGAGCAGTGCCCCCCAATAGGCT
CGATCCTGCCCAGATTGGGGCGCT -> GATCCTGCCCAGATTGGGGCGCTC
ACGGCACTATCGGGCACCAGCAGT -> CGGCACTATCGGGCACCAGCAGTT
GGCTACCAGAGCAGTGCCCCCCAA -> GCTACCAGAGCAGTGCCCCCCAAT
GCGTGTAGCCCGACTGAACAGGGC -> CGTGTAGCCCGACTGAACAGGGCC
TAGATGGGGCCTAGTGGTCTAAGA -> AGATGGGGCCTAGTGGTCTAAGAG
TGAACGGCCCAGATATAGTGGTCC -> GAACGGCCCAGATATAGTGGTCCA
ACGTGGATACCTGCTCCCTTGGCT -> CGTGGATACCTGCTCCCTTGGCTT
TCTCCTATAGCGCCCTGTCGGTCT -> CTCCTATAGCGCCCTGTCGGTCTA
TTCGCATGCGAGTTATCAGGTCCA -> TCGCATGCGAGTTATCAGGTCCAT
ACATTTCAGCGTCAGTATCCTATA -> CATTTCAGCGTCAGTATCCTATAA
GCCGATTTATCCCAATCTTGTGCT -> CCGATTTATCCCAATCTTGTGCTT
TTTAGACTATGCTTTAGGTCCGAG -> TTAGACTATGCTTTAGGTCCGAGC
CTACATTGTGTGGTGATGCCCCTT -> TACATTGTGTGGTGATGCCCCTTC
CAATTGGTCCGTGGTTGCAACGCC -> AATTGGTCCGTGGTTGCAACGCCC
AATGGCAAGCTACATTGTGTGGTG -> ATGGCAAGCTACATTGTGTGGTGA
AAGAACAAACTTCCTTGGATGCCA -> AGAACAAACTTCCTTGGATGCCAG
TTGCCGAGTCAGTCGGTAACACAT -> TGCCGAGTCAGTCGGTAACACATA
ATATAGTGGTCCATGCTAGAGAGT -> TATAGTGGTCCATGCTAGAGAGTC
CGAACAGAGTAATCGTTTTGGATA -> GAACAGAGTAATCGTTTTGGATAT
TCGTTACGAACAGAGTAATCGTTT -> CGTTACGAACAGAGTAATCGTTTT
GCACCAGCAGTTGTCTGTTTATAA -> CACCAGCAGTTGTCTGTTTATAAA
TGGCGGTCAACGTACGCAGGGGTT -> GGCGGTCAACGTACGCAGGGGTTG
ACGATCCTGCCCAGATTGGGGCGC -> CGATCCTGCCCAGATTGGGGCGCT
CGGTTCCGGAAACTAGACTAGATC -> GGTTCCGGAAACTAGACTAGATCA
CCTATAAAGATACTTGTGTTGACA -> CTATAAAGATACTTGTGTTGACAA
TAACAGTTGTTTAGATATAGAAAC -> AACAGTTGTTTAGATATAGAAACT
AGGCGCTGTACACCCTTCTAATTG -> GGCGCTGTACACCCTTCTAATTGC
GAACAGGGCCGATTTATCCCAATC -> AACAGGGCCGATTTATCCCAATCT
TCAGCGTCAGTATCCTATAAAGAT -> CAGCGTCAGTATCCTATAAAGATA
TAGCAGGGTCTCCTATAGCGCCCT -> AGCAGGGTCTCCTATAGCGCCCTG
TTAATAGTACCCGAGAGGATAATT -> TAATAGTACCCGAGAGGATAATTC
TTAGACCGGTTCCGGAAACTAGAC -> TAGACCGGTTCCGGAAACTAGACT
ACTACCAAGGTGCCACGTGAAACG -> CTACCAAGGTGCCACGTGAAACGG
GTTGTTTAGATATAGAAACTCAGC -> TTGTTTAGATATAGAAACTCAGCA
CGTGGTTGCAACGCCCCTCTTGAG -> GTGGTTGCAACGCCCCTCTTGAGC
TGACAATTACTCGGGTTGCGAATC -> GACAATTACTCGGGTTGCGAATCT
AGGCGAACCCCGTTCTCCCGAGTG -> GGCGAACCCCGTTCTCCCGAGTGT
AACGCCCCTCTTGAGCGGGCTCCA -> ACGCCCCTCTTGAGCGGGCTCCAT
CCTAATTTTTTAGCGCAACTATTG -> CTAATTTTTTAGCGCAACTATTGA
GAGTCACTATGGGATGTATCGATA -> AGTCACTATGGGATGTATCGATAC
GGATAATTCGATGTTATGTTAGCG -> GATAATTCGATGTTATGTTAGCGA
GCTAGAAGCGTGCAGCGGAGCTGG -> CTAGAAGCGTGCAGCGGAGCTGGG
ACGTATCTCTACTCGTGAAGGTCA -> CGTATCTCTACTCGTGAAGGTCAG
TTCTCCCGAGTGTGTTAGACCGGT -> TCTCCCGAGTGTGTTAGACCGGTT
TAATGGAATATACGAGACACAAGA -> AATGGAATATACGAGACACAAGAG
CCAGAAGGGCTAATTAGCCGGAAA -> CAGAAGGGCTAATTAGCCGGAAAA
TAATCGTCCCTATAGCCCTGACAC -> AATCGTCCCTATAGCCCTGACACT
GGTCCATGCAGAATCCATACGCGA -> GTCCATGCAGAATCCATACGCGAT
CCTAGCAGCATGTGTGGAAGTGAA -> CTAGCAGCATGTGTGGAAGTGAAC
CGTGAAACGGTTCTCTGAGGGATG -> GTGAAACGGTTCTCTGAGGGATGC
GCTTACCCTTTCGCATGCGAGTTA -> CTTACCCTTTCGCATGCGAGTTAT
GAGGGATGCGGACATGATACCTTC -> AGGGATGCGGACATGATACCTTCG
TGAGGGATGCGGACATGATACCTT -> GAGGGATGCGGACATGATACCTTC
CATACGCGATACCTAGGCTGAACG -> ATACGCGATACCTAGGCTGAACGG
GTCCATGCAGAATCCATACGCGAT -> TCCATGCAGAATCCATACGCGATA
GGCACTATCGGGCACCAGCAGTTG -> GCACTATCGGGCACCAGCAGTTGT
TTCTGCATATTGCCATAATTTACA -> TCTGCATATTGCCATAATTTACAA
ACAACCTGAAGACGGGCGTGTAGC -> CAACCTGAAGACGGGCGTGTAGCC
CTAATGCCTATGCTAGGCACGCAC -> TAATGCCTATGCTAGGCACGCACT
AATACCTCATCGGGGTGACGCACT -> ATACCTCATCGGGGTGACGCACTA
AACAATGTGTTAGTGGAAGGGGTG -> ACAATGTGTTAGTGGAAGGGGTGT
TAAAGATACTTGTGTTGACAATTA -> AAAGATACTTGTGTTGACAATTAC
TGATGCCCCTTCCACTTAATCGTC -> GATGCCCCTTCCACTTAATCGTCC
GAACAATGTGTTAGTGGAAGGGGT -> AACAATGTGTTAGTGGAAGGGGTG
TCGCGAGGAATACCTCATCGGGGT -> CGCGAGGAATACCTCATCGGGGTG
AGAGTTTAAGATCTGAGTACCTAT -> GAGTTTAAGATCTGAGTACCTATT
GAACGTTGTTATGAATCGACGCTC -> AACGTTGTTATGAATCGACGCTCA
TGTGACTTTCGGGTCTTTATCCTA -> GTGACTTTCGGGTCTTTATCCTAA
CCCGAGAGTCACTATGGGATGTAT -> CCGAGAGTCACTATGGGATGTATC
CAGCCTGGACACTGAACCTGGCTG -> AGCCTGGACACTGAACCTGGCTGT
TTTACCCGTAGTTAAAAATGTGGC -> TTACCCGTAGTTAAAAATGTGGCC
CTGAACAGGGCCGATTTATCCCAA -> TGAACAGGGCCGATTTATCCCAAT
TGGTCCATGCTAGAGAGTCAGTAC -> GGTCCATGCTAGAGAGTCAGTACA
CCTATAATAAAAATCCTTTGTATC -> CTATAATAAAAATCCTTTGTATCA
GCAGGGTCTCCTATAGCGCCCTGT -> CAGGGTCTCCTATAGCGCCCTGTC
ATTAGCAGGGTCTCCTATAGCGCC -> TTAGCAGGGTCTCCTATAGCGCCC
TAAAAATGTGGCCCCTGTGACGAT -> AAAAATGTGGCCCCTGTGACGATC
CCAAACCCCCACCCGGCTGATTCT -> CAAACCCCCACCCGGCTGATTCTG
TTATCAGGTCCATGCAGAATCCAT -> TATCAGGTCCATGCAGAATCCATA
ATTTACTTGATATCTACGTGGGAC -> TTTACTTGATATCTACGTGGGACC
GCTGATTCTGCATATTGCCATAAT -> CTGATTCTGCATATTGCCATAATT
GAACTTCGTAGGTAACCATTATGT -> AACTTCGTAGGTAACCATTATGTG
TTGCGGTGGGGCTACCAGAGCAGT -> TGCGGTGGGGCTACCAGAGCAGTG
TCCATGCTAGAGAGTCAGTACATT -> CCATGCTAGAGAGTCAGTACATTT
ACGGTTCTCTGAGGGATGCGGACA -> CGGTTCTCTGAGGGATGCGGACAT
GAATATACGAGACACAAGAGGCAA -> AATATACGAGACACAAGAGGCAAT
CCTATTCATCCGTTGCCAAGCTTG -> CTATTCATCCGTTGCCAAGCTTGA
TGGAAGGGGTGTCTCCCCGATATA -> GGAAGGGGTGTCTCCCCGATATAG
TGATCCGACTCGTGACTAAGTCCT -> GATCCGACTCGTGACTAAGTCCTC
GAATCTCCGTGGACGACGCGAGCG -> AATCTCCGTGGACGACGCGAGCGA
CACATGACCGTTGCCTAGCAGCAT -> ACATGACCGTTGCCTAGCAGCATG
CCAGTCGGACGGGAGTTGGCGGAT -> CAGTCGGACGGGAGTTGGCGGATT
CTAGGCACGCACTAGACCGCTAAT -> TAGGCACGCACTAGACCGCTAATC
TAGGTAACCATTATGTGTGATCAC -> AGGTAACCATTATGTGTGATCACT
TGGATGCCAGTCGGACGGGAGTTG -> GGATGCCAGTCGGACGGGAGTTGG
ATAGCGCCCTGTCGGTCTAGAGAT -> TAGCGCCCTGTCGGTCTAGAGATC
AGAGATCACTACCAAGGTGCCACG -> GAGATCACTACCAAGGTGCCACGT
TAATTTCCAGCCGAATCTCCGTGG -> AATTTCCAGCCGAATCTCCGTGGA
TTGCTAGAAGCGTGCAGCGGAGCT -> TGCTAGAAGCGTGCAGCGGAGCTG
CTTTTACGCGGACTCCTATAATAA -> TTTTACGCGGACTCCTATAATAAA
CGCCCTGTCGGTCTAGAGATCACT -> GCCCTGTCGGTCTAGAGATCACTA
CTAGAGATCACTACCAAGGTGCCA -> TAGAGATCACTACCAAGGTGCCAC
CAGCCAGAAGGGCTAATTAGCCGG -> AGCCAGAAGGGCTAATTAGCCGGA
CAGACCAAGAACAAACTTCCTTGG -> AGACCAAGAACAAACTTCCTTGGA
CTAAGACAACGGCACTATCGGGCA -> TAAGACAACGGCACTATCGGGCAC
TAGTTCCCTCGCTCGCCCGAGAGT -> AGTTCCCTCGCTCGCCCGAGAGTC
TCCACTTAATCGTCCCTATAGCCC -> CCACTTAATCGTCCCTATAGCCCT
CTTTAGGTCCGAGCTTTACCCGTA -> TTTAGGTCCGAGCTTTACCCGTAG
GCCAAGCTTGATTTCGAAACTGGC -> CCAAGCTTGATTTCGAAACTGGCA
TCATGAACATACGCCCCTCCCTTG -> CATGAACATACGCCCCTCCCTTGC
ATAAAGATACTTGTGTTGACAATT -> TAAAGATACTTGTGTTGACAATTA
AGGCACGCACTAGACCGCTAATCG -> GGCACGCACTAGACCGCTAATCGC
CCGACTGAACAGGGCCGATTTATC -> CGACTGAACAGGGCCGATTTATCC
TGACTTTCGGGTCTTTATCCTAAT -> GACTTTCGGGTCTTTATCCTAATG
GATGCGGACATGATACCTTCGTGG -> ATGCGGACATGATACCTTCGTGGT
AGACCGCACCATTTGCAAGAACAA -> GACCGCACCATTTGCAAGAACAAT
TGGTCCGAGCCTTGAGGTGCGACT -> GGTCCGAGCCTTGAGGTGCGACTT
TTACGAACAGAGTAATCGTTTTGG -> TACGAACAGAGTAATCGTTTTGGA
CTTCCTAATTTTTTAGCGCAACTA -> TTCCTAATTTTTTAGCGCAACTAT
ATGCCTATGCTAGGCACGCACTAG -> TGCCTATGCTAGGCACGCACTAGA
TCGCGGTCTATGCTCTTGCTTTTA -> CGCGGTCTATGCTCTTGCTTTTAC
ACAACGGCACTATCGGGCACCAGC -> CAACGGCACTATCGGGCACCAGCA
AAGATACTTGTGTTGACAATTACT -> AGATACTTGTGTTGACAATTACTC
AAGACGCTAATTAATAGTACCCGA -> AGACGCTAATTAATAGTACCCGAG
AACAGGGCCGATTTATCCCAATCT -> ACAGGGCCGATTTATCCCAATCTT
CCTGCTCCCTTGGCTTATCGGCCC -> CTGCTCCCTTGGCTTATCGGCCCT
AACCTGGCTGTGCGATGTAGACAT -> ACCTGGCTGTGCGATGTAGACATT
CGTGCAGCGGAGCTGGGAACGACG -> GTGCAGCGGAGCTGGGAACGACGC
CTGCCTCGCGGTCTATGCTCTTGC -> TGCCTCGCGGTCTATGCTCTTGCT
TCCCTCGCTCGCCCGAGAGTCACT -> CCCTCGCTCGCCCGAGAGTCACTA
AATATCCTCTTTACGTCACATGAC -> ATATCCTCTTTACGTCACATGACC
GTACCTATTCATCCGTTGCCAAGC -> TACCTATTCATCCGTTGCCAAGCT
AGCGAATTGTGCCTTTAGGCTGTT -> GCGAATTGTGCCTTTAGGCTGTTG
TCGGTTGGCCTTTCGCATTGAATG -> CGGTTGGCCTTTCGCATTGAATGT
TTACAATTATTTACTTGATATCTA -> TACAATTATTTACTTGATATCTAC
CTTTCAGTGCTAGGAACGTCCTCG -> TTTCAGTGCTAGGAACGTCCTCGA
CAATCGACGAGCGATCTACAAAGT -> AATCGACGAGCGATCTACAAAGTT
ATCCATACGCGATACCTAGGCTGA -> TCCATACGCGATACCTAGGCTGAA
GCTTAGAGGTAAAACGCCGGCGTT -> CTTAGAGGTAAAACGCCGGCGTTA
GGGTCTTTATCCTAATGCCTATGC -> GGTCTTTATCCTAATGCCTATGCT
TACCTAGGCTGAACGGCCCAGATA -> ACCTAGGCTGAACGGCCCAGATAT
ACGCGATACCTAGGCTGAACGGCC -> CGCGATACCTAGGCTGAACGGCCC
TACGTTTGCTAGAAGCGTGCAGCG -> ACGTTTGCTAGAAGCGTGCAGCGG
AATGTGGCCCCTGTGACGATCCTG -> ATGTGGCCCCTGTGACGATCCTGC
CCGCGACAATCTGCAGTGTCGCCA -> CGCGACAATCTGCAGTGTCGCCAG
CGTGTAGCCCGACTGAACAGGGCC -> GTGTAGCCCGACTGAACAGGGCCG
GGAACGACGCCTAAGACAACGGCA -> GAACGACGCCTAAGACAACGGCAC
CGCACTAATATGAGACTAACAGTT -> GCACTAATATGAGACTAACAGTTG
CCTGTGACGATCCTGCCCAGATTG -> CTGTGACGATCCTGCCCAGATTGG
TGGATACCTGCTCCCTTGGCTTAT -> GGATACCTGCTCCCTTGGCTTATC
TAGTGGAAGGGGTGTCTCCCCGAT -> AGTGGAAGGGGTGTCTCCCCGATA
AGCGTCAGTATCCTATAAAGATAC -> GCGTCAGTATCCTATAAAGATACT
CCTGTCGGTCTAGAGATCACTACC -> CTGTCGGTCTAGAGATCACTACCA
ACATTGTGTGGTGATGCCCCTTCC -> CATTGTGTGGTGATGCCCCTTCCA
TATCAGGTCCATGCAGAATCCATA -> ATCAGGTCCATGCAGAATCCATAC
TACTTGATATCTACGTGGGACCGA -> ACTTGATATCTACGTGGGACCGAC
CGGCAGCCTTCCTAATTTTTTAGC -> GGCAGCCTTCCTAATTTTTTAGCG
ATCTCTACTCGTGAAGGTCAGAAG -> TCTCTACTCGTGAAGGTCAGAAGC
GGATGCGGACATGATACCTTCGTG -> GATGCGGACATGATACCTTCGTGG
GTCGCCAGACCAAGAACAAACTTC -> TCGCCAGACCAAGAACAAACTTCC
CTAGATCATTAATATCCTCTTTAC -> TAGATCATTAATATCCTCTTTACG
ACTACGTCGACTGTAGACGGGCAG -> CTACGTCGACTGTAGACGGGCAGT
AATAAAAATCCTTTGTATCAAAAA -> ATAAAAATCCTTTGTATCAAAAAA
CGTGACTAAGTCCTCAGCCTGGAC -> GTGACTAAGTCCTCAGCCTGGACA
AGCGCCCTGTCGGTCTAGAGATCA -> GCGCCCTGTCGGTCTAGAGATCAC
GAAAAGGCGACGAGAAAATACTCT -> AAAAGGCGACGAGAAAATACTCTT
GCATTCTCGTTACGAACAGAGTAA -> CATTCTCGTTACGAACAGAGTAAT
AACAGAGGCGAACCCCGTTCTCCC -> ACAGAGGCGAACCCCGTTCTCCCG
TACGCGATACCTAGGCTGAACGGC -> ACGCGATACCTAGGCTGAACGGCC
GGTGTCTCCCCGATATAGAGCATT -> GTGTCTCCCCGATATAGAGCATTC
GTGTGGCTAATCGCTCCCTGATCC -> TGTGGCTAATCGCTCCCTGATCCG
ATTTCGAAACTGGCATGCACCAGG -> TTTCGAAACTGGCATGCACCAGGA
CGTTGCCTAGCAGCATGTGTGGAA -> GTTGCCTAGCAGCATGTGTGGAAG
GATACCACATGGCGGTCAACGTAC -> ATACCACATGGCGGTCAACGTACG
AAAATACTCTTGTAGCCGCTTACC -> AAATACTCTTGTAGCCGCTTACCC
GTTAGTGGAAGGGGTGTCTCCCCG -> TTAGTGGAAGGGGTGTCTCCCCGA
GAGACACAAGAGGCAATCGACGAG -> AGACACAAGAGGCAATCGACGAGC
GAGTGAGAGAGCGTCATAGACCGC -> AGTGAGAGAGCGTCATAGACCGCA
ACGCCGGCGTTATTAGCAGGGTCT -> CGCCGGCGTTATTAGCAGGGTCTC
CGATCTACAAAGTTAACTGGGCGA -> GATCTACAAAGTTAACTGGGCGAG
GACATTTTAGACTATGCTTTAGGT -> ACATTTTAGACTATGCTTTAGGTC
AAACGCCGGCGTTATTAGCAGGGT -> AACGCCGGCGTTATTAGCAGGGTC
CCTCATCGGGGTGACGCACTAATA -> CTCATCGGGGTGACGCACTAATAT
CGGAAACTAGACTAGATCATTAAT -> GGAAACTAGACTAGATCATTAATA
GGACACTGAACCTGGCTGTGCGAT -> GACACTGAACCTGGCTGTGCGATG
CCAGGATACGCTTAGAGGTAAAAC -> CAGGATACGCTTAGAGGTAAAACG
GGGTCTCCTATAGCGCCCTGTCGG -> GGTCTCCTATAGCGCCCTGTCGGT
GGCAACAGAGGCGAACCCCGTTCT -> GCAACAGAGGCGAACCCCGTTCTC
CTACGTCGACTGTAGACGGGCAGT -> TACGTCGACTGTAGACGGGCAGTG
TCGGGTCTTTATCCTAATGCCTAT -> CGGGTCTTTATCCTAATGCCTATG
ACGTTGTTATGAATCGACGCTCAC -> CGTTGTTATGAATCGACGCTCACA
GACACTGAACCTGGCTGTGCGATG -> ACACTGAACCTGGCTGTGCGATGT
GACTGTAGACGGGCAGTGTGGCTA -> ACTGTAGACGGGCAGTGTGGCTAA
TTTAGATATAGAAACTCAGCACCA -> TTAGATATAGAAACTCAGCACCAG
GTAGCAGCCAGAAGGGCTAATTAG -> TAGCAGCCAGAAGGGCTAATTAGC
ACGCCCCTCCCTTGCGGGATGTCA -> CGCCCCTCCCTTGCGGGATGTCAC
GGCAAGCTACATTGTGTGGTGATG -> GCAAGCTACATTGTGTGGTGATGC
CGGCCCTCGGAAAACCGCAATTGG -> GGCCCTCGGAAAACCGCAATTGGT
GGACATGATACCTTCGTGGTCCGA -> GACATGATACCTTCGTGGTCCGAG
CGTAGTTAAAAATGTGGCCCCTGT -> GTAGTTAAAAATGTGGCCCCTGTG
ACCGCGACAATCTGCAGTGTCGCC -> CCGCGACAATCTGCAGTGTCGCCA
CGGAAAAGGCGACGAGAAAATACT -> GGAAAAGGCGACGAGAAAATACTC
ATGTGTGGAAGTGAACGTTGTTAT -> TGTGTGGAAGTGAACGTTGTTATG
CGCAATTGGTCCGTGGTTGCAACG -> GCAATTGGTCCGTGGTTGCAACGC
CCAGATTGGGGCGCTCCCCCTTGA -> CAGATTGGGGCGCTCCCCCTTGAA
GTCAGAAGCCATAGAGTTTAAGAT -> TCAGAAGCCATAGAGTTTAAGATC
CGATACCTAGGCTGAACGGCCCAG -> GATACCTAGGCTGAACGGCCCAGA
AGCAGTTGTCTGTTTATAAAGGGC -> GCAGTTGTCTGTTTATAAAGGGCT
TAGACGGGCAGTGTGGCTAATCGC -> AGACGGGCAGTGTGGCTAATCGCT
TCTGTGGGTAGCAGCCAGAAGGGC -> CTGTGGGTAGCAGCCAGAAGGGCT
AGTCCTCAGCCTGGACACTGAACC -> GTCCTCAGCCTGGACACTGAACCT
CGCTCACACGCATAGCCTGTCCGG -> GCTCACACGCATAGCCTGTCCGGC
AACGACGCCTAAGACAACGGCACT -> ACGACGCCTAAGACAACGGCACTA
GTCGGACGGGAGTTGGCGGATTCC -> TCGGACGGGAGTTGGCGGATTCCC
GGTCTATGCTCTTGCTTTTACGCG -> GTCTATGCTCTTGCTTTTACGCGG
GTATCCTATAAAGATACTTGTGTT -> TATCCTATAAAGATACTTGTGTTG
GAAGCGTGCAGCGGAGCTGGGAAC -> AAGCGTGCAGCGGAGCTGGGAACG
ACCAGCAGTTGTCTGTTTATAAAG -> CCAGCAGTTGTCTGTTTATAAAGG
CTTTGTATCAAAAAATAGATGGGG -> TTTGTATCAAAAAATAGATGGGGC
GGCGAACCCCGTTCTCCCGAGTGT -> GCGAACCCCGTTCTCCCGAGTGTG
GCTTATCGGCCCTCGGAAAACCGC -> CTTATCGGCCCTCGGAAAACCGCA
GGGCCGATTTATCCCAATCTTGTG -> GGCCGATTTATCCCAATCTTGTGC
CATGCGAGTTATCAGGTCCATGCA -> ATGCGAGTTATCAGGTCCATGCAG
TCTTGGTGTGCATAGGACCAGTAC -> CTTGGTGTGCATAGGACCAGTACG
GATGTTATGTTAGCGAATTGTGCC -> ATGTTATGTTAGCGAATTGTGCCT
GCTAATCGCGCGAACTTCGTAGGT -> CTAATCGCGCGAACTTCGTAGGTA
GCAGCCAGAAGGGCTAATTAGCCG -> CAGCCAGAAGGGCTAATTAGCCGG
GAGAAAATACTCTTGTAGCCGCTT -> AGAAAATACTCTTGTAGCCGCTTA
AGCAGCATGTGTGGAAGTGAACGT -> GCAGCATGTGTGGAAGTGAACGTT
CTAATTAGCCGGAAAAGGCGACGA -> TAATTAGCCGGAAAAGGCGACGAG
GCAGTTGTCTGTTTATAAAGGGCT -> CAGTTGTCTGTTTATAAAGGGCTA
TGACTAAGTCCTCAGCCTGGACAC -> GACTAAGTCCTCAGCCTGGACACT
AACGGCACTATCGGGCACCAGCAG -> ACGGCACTATCGGGCACCAGCAGT
GCGACTATAGTTCCCTCGCTCGCC -> CGACTATAGTTCCCTCGCTCGCCC
TTACTTGATATCTACGTGGGACCG -> TACTTGATATCTACGTGGGACCGA
TGGGATGTATCGATACCACATGGC -> GGGATGTATCGATACCACATGGCG
CTAGGAACGTCCTCGAGAGACCAA -> TAGGAACGTCCTCGAGAGACCAAA
CGAATCTGAACAATGGCAAGCTAC -> GAATCTGAACAATGGCAAGCTACA
GGCCCTCGGAAAACCGCAATTGGT -> GCCCTCGGAAAACCGCAATTGGTC
ACATGGCGGTCAACGTACGCAGGG -> CATGGCGGTCAACGTACGCAGGGG
GCAGTGTCGCCAGACCAAGAACAA -> CAGTGTCGCCAGACCAAGAACAAA
CTTGTAGCCGCTTACCCTTTCGCA -> TTGTAGCCGCTTACCCTTTCGCAT
TCCGTGGTTGCAACGCCCCTCTTG -> CCGTGGTTGCAACGCCCCTCTTGA
TCTTGCTTTTACGCGGACTCCTAT -> CTTGCTTTTACGCGGACTCCTATA
TAATATGAGACTAACAGTTGTTTA -> AATATGAGACTAACAGTTGTTTAG
GTTCTCTGAGGGATGCGGACATGA -> TTCTCTGAGGGATGCGGACATGAT
ACTCAGCACCAGGTCTTGGTGTGC -> CTCAGCACCAGGTCTTGGTGTGCA
AAGGGGTGTCTCCCCGATATAGAG -> AGGGGTGTCTCCCCGATATAGAGC
GTTCTTAAGACGCTAATTAATAGT -> TTCTTAAGACGCTAATTAATAGTA
GGTCTAAGAGTCGCGAGGAATACC -> GTCTAAGAGTCGCGAGGAATACCT
ATTACTCGGGTTGCGAATCTGAAC -> TTACTCGGGTTGCGAATCTGAACA
GGTAACACATACTCGCTTTCAGTG -> GTAACACATACTCGCTTTCAGTGC
TACGTGGGACCGACAAGTGGCTTG -> ACGTGGGACCGACAAGTGGCTTGA
CTCTTGAGCGGGCTCCATTGCACC -> TCTTGAGCGGGCTCCATTGCACCG
CATACGCCCCTCCCTTGCGGGATG -> ATACGCCCCTCCCTTGCGGGATGT
ATAGTACCCGAGAGGATAATTCGA -> TAGTACCCGAGAGGATAATTCGAT
AGACAACGGCACTATCGGGCACCA -> GACAACGGCACTATCGGGCACCAG
TGCTCTTGCTTTTACGCGGACTCC -> GCTCTTGCTTTTACGCGGACTCCT
TCCGACTCGTGACTAAGTCCTCAG -> CCGACTCGTGACTAAGTCCTCAGC
GACTAAGTCCTCAGCCTGGACACT -> ACTAAGTCCTCAGCCTGGACACTG
ACGACGCCTAAGACAACGGCACTA -> CGACGCCTAAGACAACGGCACTAT
GCTAGAGAGTCAGTACATTTCAGC -> CTAGAGAGTCAGTACATTTCAGCG
AGAGGATAATTCGATGTTATGTTA -> GAGGATAATTCGATGTTATGTTAG
CTATCGGGCACCAGCAGTTGTCTG -> TATCGGGCACCAGCAGTTGTCTGT
CGTGGTCCGAGCCTTGAGGTGCGA -> GTGGTCCGAGCCTTGAGGTGCGAC
ACATACGCCCCTCCCTTGCGGGAT -> CATACGCCCCTCCCTTGCGGGATG
GATATCTACGTGGGACCGACAAGT -> ATATCTACGTGGGACCGACAAGTG
AACGCCGGCGTTATTAGCAGGGTC -> ACGCCGGCGTTATTAGCAGGGTCT
TTTATCCTAATGCCTATGCTAGGC -> TTATCCTAATGCCTATGCTAGGCA
ACTAAGTCCTCAGCCTGGACACTG -> CTAAGTCCTCAGCCTGGACACTGA
TTGATTTCGAAACTGGCATGCACC -> TGATTTCGAAACTGGCATGCACCA
CCTCGCTCGCCCGAGAGTCACTAT -> CTCGCTCGCCCGAGAGTCACTATG
AAAAAATAGATGGGGCCTAGTGGT -> AAAAATAGATGGGGCCTAGTGGTC
CGCATAGCCTGTCCGGCAGCCTTC -> GCATAGCCTGTCCGGCAGCCTTCC
ATCGATACCACATGGCGGTCAACG -> TCGATACCACATGGCGGTCAACGT
GAGTTGGCGGATTCCCTAGACTAC -> AGTTGGCGGATTCCCTAGACTACG
GCTTGATAATGGAATATACGAGAC -> CTTGATAATGGAATATACGAGACA
GAGCGTCATAGACCGCACCATTTG -> AGCGTCATAGACCGCACCATTTGC
TGGCATGCACCAGGATACGCTTAG -> GGCATGCACCAGGATACGCTTAGA
CGTCAGTATCCTATAAAGATACTT -> GTCAGTATCCTATAAAGATACTTG
GAGAGGATAATTCGATGTTATGTT -> AGAGGATAATTCGATGTTATGTTA
CGAGTCAGTCGGTAACACATACTC -> GAGTCAGTCGGTAACACATACTCG
TGAGCGGGCTCCATTGCACCGCGA -> GAGCGGGCTCCATTGCACCGCGAC
CGATATAGAGCATTCTCGTTACGA -> GATATAGAGCATTCTCGTTACGAA
ATGGCAAGCTACATTGTGTGGTGA -> TGGCAAGCTACATTGTGTGGTGAT
ACGCAGGGGTTGCCGAGTCAGTCG -> CGCAGGGGTTGCCGAGTCAGTCGG
GCAACGCCCCTCTTGAGCGGGCTC -> CAACGCCCCTCTTGAGCGGGCTCC
CCCGTTCTCCCGAGTGTGTTAGAC -> CCGTTCTCCCGAGTGTGTTAGACC
AGTGGTCTAAGAGTCGCGAGGAAT -> GTGGTCTAAGAGTCGCGAGGAATA
TCCGGAAACTAGACTAGATCATTA -> CCGGAAACTAGACTAGATCATTAA
CCCCTCCCTTGCGGGATGTCACAC -> CCCTCCCTTGCGGGATGTCACACG
CCCCGTTCTCCCGAGTGTGTTAGA -> CCCGTTCTCCCGAGTGTGTTAGAC
CTCAGCACCAGGTCTTGGTGTGCA -> TCAGCACCAGGTCTTGGTGTGCAT
ATGCTAGAGAGTCAGTACATTTCA -> TGCTAGAGAGTCAGTACATTTCAG
ATAGGCTACTATGTGACTTTCGGG -> TAGGCTACTATGTGACTTTCGGGT
TTCCCTAGACTACGTCGACTGTAG -> TCCCTAGACTACGTCGACTGTAGA
GCCTTCCTAATTTTTTAGCGCAAC -> CCTTCCTAATTTTTTAGCGCAACT
GCTCCATTGCACCGCGACAATCTG -> CTCCATTGCACCGCGACAATCTGC
GGGTGACGCACTAATATGAGACTA -> GGTGACGCACTAATATGAGACTAA
TTTGTATCAAAAAATAGATGGGGC -> TTGTATCAAAAAATAGATGGGGCC
AGGGGTGTCTCCCCGATATAGAGC -> GGGGTGTCTCCCCGATATAGAGCA
TTTTAGCGCAACTATTGATTAGAT -> TTTAGCGCAACTATTGATTAGATC
ATCGGCCCTCGGAAAACCGCAATT -> TCGGCCCTCGGAAAACCGCAATTG
CAGCCTTCCTAATTTTTTAGCGCA -> AGCCTTCCTAATTTTTTAGCGCAA
GGTGATGCCCCTTCCACTTAATCG -> GTGATGCCCCTTCCACTTAATCGT
GTCCCTATAGCCCTGACACTCTTA -> TCCCTATAGCCCTGACACTCTTAG
ACGCTCACACGCATAGCCTGTCCG -> CGCTCACACGCATAGCCTGTCCGG
GACCGCTAATCGCGCGAACTTCGT -> ACCGCTAATCGCGCGAACTTCGTA
TCGTGAAGGTCAGAAGCCATAGAG -> CGTGAAGGTCAGAAGCCATAGAGT
GTGGTCCGAGCCTTGAGGTGCGAC -> TGGTCCGAGCCTTGAGGTGCGACT
TTTGCTAGAAGCGTGCAGCGGAGC -> TTGCTAGAAGCGTGCAGCGGAGCT
GCACTAATATGAGACTAACAGTTG -> CACTAATATGAGACTAACAGTTGT
GTTGTCTGTTTATAAAGGGCTACC -> TTGTCTGTTTATAAAGGGCTACCT
TCAGAAGCCATAGAGTTTAAGATC -> CAGAAGCCATAGAGTTTAAGATCT
GAGGCGAACCCCGTTCTCCCGAGT -> AGGCGAACCCCGTTCTCCCGAGTG
ACATGACCGTTGCCTAGCAGCATG -> CATGACCGTTGCCTAGCAGCATGT
TCCCTTGCGGGATGTCACACGTGG -> CCCTTGCGGGATGTCACACGTGGA
AAATACTCTTGTAGCCGCTTACCC -> AATACTCTTGTAGCCGCTTACCCT
ATACCTGCTCCCTTGGCTTATCGG -> TACCTGCTCCCTTGGCTTATCGGC
CCTATAGCGCCCTGTCGGTCTAGA -> CTATAGCGCCCTGTCGGTCTAGAG
GGCTGATTCTGCATATTGCCATAA -> GCTGATTCTGCATATTGCCATAAT
AGTTAACTGGGCGAGCTGCGAGGC -> GTTAACTGGGCGAGCTGCGAGGCG
TATAGAAACTCAGCACCAGGTCTT -> ATAGAAACTCAGCACCAGGTCTTG
CAGTCGGTAACACATACTCGCTTT -> AGTCGGTAACACATACTCGCTTTC
ATACGCCCCTCCCTTGCGGGATGT -> TACGCCCCTCCCTTGCGGGATGTC
AGCCTTCCTAATTTTTTAGCGCAA -> GCCTTCCTAATTTTTTAGCGCAAC
ATATAGAGCATTCTCGTTACGAAC -> TATAGAGCATTCTCGTTACGAACA
CGCGATACCTAGGCTGAACGGCCC -> GCGATACCTAGGCTGAACGGCCCA
GATGCCAGTCGGACGGGAGTTGGC -> ATGCCAGTCGGACGGGAGTTGGCG
AGGGCTACCTGGCAACAGAGGCGA -> GGGCTACCTGGCAACAGAGGCGAA
GGAAGTGAACGTTGTTATGAATCG -> GAAGTGAACGTTGTTATGAATCGA
GGGCAGTGTGGCTAATCGCTCCCT -> GGCAGTGTGGCTAATCGCTCCCTG
TGCAGAATCCATACGCGATACCTA -> GCAGAATCCATACGCGATACCTAG
CCCTCGCTCGCCCGAGAGTCACTA -> CCTCGCTCGCCCGAGAGTCACTAT
AACTATTGATTAGATCATCAGGTA -> ACTATTGATTAGATCATCAGGTAT
TTCCAGCCGAATCTCCGTGGACGA -> TCCAGCCGAATCTCCGTGGACGAC
GAGCCTTGAGGTGCGACTTGTTCT -> AGCCTTGAGGTGCGACTTGTTCTT
TTCAGCGTCAGTATCCTATAAAGA -> TCAGCGTCAGTATCCTATAAAGAT
ATGGGGCCTAGTGGTCTAAGAGTC -> TGGGGCCTAGTGGTCTAAGAGTCG
AGTGGCTTGATAATGGAATATACG -> GTGGCTTGATAATGGAATATACGA
GGCAGCCTTCCTAATTTTTTAGCG -> GCAGCCTTCCTAATTTTTTAGCGC
GCGAGGCGCTGTACACCCTTCTAA -> CGAGGCGCTGTACACCCTTCTAAT
GAACAAACTTCCTTGGATGCCAGT -> AACAAACTTCCTTGGATGCCAGTC
ACCTTCGTGGTCCGAGCCTTGAGG -> CCTTCGTGGTCCGAGCCTTGAGGT
CTACTCGTGAAGGTCAGAAGCCAT -> TACTCGTGAAGGTCAGAAGCCATA
CTGCTCCCTTGGCTTATCGGCCCT -> TGCTCCCTTGGCTTATCGGCCCTC
CGCCCGAGAGTCACTATGGGATGT -> GCCCGAGAGTCACTATGGGATGTA
GTCTATGCTCTTGCTTTTACGCGG -> TCTATGCTCTTGCTTTTACGCGGA
GAAACGGTTCTCTGAGGGATGCGG -> AAACGGTTCTCTGAGGGATGCGGA
TCCTAATGCCTATGCTAGGCACGC -> CCTAATGCCTATGCTAGGCACGCA
TTAACTGGGCGAGCTGCGAGGCGC -> TAACTGGGCGAGCTGCGAGGCGCT
TTGCCATAATTTACAATTATTTAC -> TGCCATAATTTACAATTATTTACT
GTCTGTTTATAAAGGGCTACCTGG -> TCTGTTTATAAAGGGCTACCTGGC
ACTCGCTTTCAGTGCTAGGAACGT -> CTCGCTTTCAGTGCTAGGAACGTC
GTATTACGTTTGCTAGAAGCGTGC -> TATTACGTTTGCTAGAAGCGTGCA
TTTCCAGCCGAATCTCCGTGGACG -> TTCCAGCCGAATCTCCGTGGACGA
GACTCGTGACTAAGTCCTCAGCCT -> ACTCGTGACTAAGTCCTCAGCCTG
TCGAAACTGGCATGCACCAGGATA -> CGAAACTGGCATGCACCAGGATAC
CCTCGAGAGACCAAACCCCCACCC -> CTCGAGAGACCAAACCCCCACCCG
AGTCACTATGGGATGTATCGATAC -> GTCACTATGGGATGTATCGATACC
GCCAGACCAAGAACAAACTTCCTT -> CCAGACCAAGAACAAACTTCCTTG
TTTCGCATTGAATGTATTACGTTT -> TTCGCATTGAATGTATTACGTTTG
CTTACCCTTTCGCATGCGAGTTAT -> TTACCCTTTCGCATGCGAGTTATC
AACTAGACTAGATCATTAATATCC -> ACTAGACTAGATCATTAATATCCT
GCGGACTCCTATAATAAAAATCCT -> CGGACTCCTATAATAAAAATCCTT
TGAACAATGGCAAGCTACATTGTG -> GAACAATGGCAAGCTACATTGTGT
AGGAATACCTCATCGGGGTGACGC -> GGAATACCTCATCGGGGTGACGCA
ATTGTGCCTTTAGGCTGTTGACAA -> TTGTGCCTTTAGGCTGTTGACAAC
ATCAGGTATAGCTCGTTGAACTGT -> TCAGGTATAGCTCGTTGAACTGTC
AAGTGAACGTTGTTATGAATCGAC -> AGTGAACGTTGTTATGAATCGACG
ATGTTAGCGAATTGTGCCTTTAGG -> TGTTAGCGAATTGTGCCTTTAGGC
ATGCGGACATGATACCTTCGTGGT -> TGCGGACATGATACCTTCGTGGTC
ATTTGCAAGAACAATGTGTTAGTG -> TTTGCAAGAACAATGTGTTAGTGG
GGGGTTGCCGAGTCAGTCGGTAAC -> GGGTTGCCGAGTCAGTCGGTAACA
ATTTATCCCAATCTTGTGCTTAAA -> TTTATCCCAATCTTGTGCTTAAAT
TAATAGTACCCGAGAGGATAATTC -> AATAGTACCCGAGAGGATAATTCG
TATAGCGCCCTGTCGGTCTAGAGA -> ATAGCGCCCTGTCGGTCTAGAGAT
CCAATCTTGTGCTTAAATCATGAA -> CAATCTTGTGCTTAAATCATGAAC
GAGCATTCTCGTTACGAACAGAGT -> AGCATTCTCGTTACGAACAGAGTA
TGGAAGTGAACGTTGTTATGAATC -> GGAAGTGAACGTTGTTATGAATCG
TCGGGGTGACGCACTAATATGAGA -> CGGGGTGACGCACTAATATGAGAC
AGTCGGTAACACATACTCGCTTTC -> GTCGGTAACACATACTCGCTTTCA
GGTTCTTCGGTTGGCCTTTCGCAT -> GTTCTTCGGTTGGCCTTTCGCATT
CAGGTATAGCTCGTTGAACTGTCA -> AGGTATAGCTCGTTGAACTGTCAC
TCCCCGATATAGAGCATTCTCGTT -> CCCCGATATAGAGCATTCTCGTTA
ATCTGAGTACCTATTCATCCGTTG -> TCTGAGTACCTATTCATCCGTTGC
CAAGGTGCCACGTGAAACGGTTCT -> AAGGTGCCACGTGAAACGGTTCTC
CGTTCTCCCGAGTGTGTTAGACCG -> GTTCTCCCGAGTGTGTTAGACCGG
CCTTGGCTTATCGGCCCTCGGAAA -> CTTGGCTTATCGGCCCTCGGAAAA
GCAGGGGTTGCCGAGTCAGTCGGT -> CAGGGGTTGCCGAGTCAGTCGGTA
GTGGTCCATGCTAGAGAGTCAGTA -> TGGTCCATGCTAGAGAGTCAGTAC
AGAACAAACTTCCTTGGATGCCAG -> GAACAAACTTCCTTGGATGCCAGT
GTCTTTATCCTAATGCCTATGCTA -> TCTTTATCCTAATGCCTATGCTAG
ATCCGACTCGTGACTAAGTCCTCA -> TCCGACTCGTGACTAAGTCCTCAG
AGCGGAGCTGGGAACGACGCCTAA -> GCGGAGCTGGGAACGACGCCTAAG
ACACGCATAGCCTGTCCGGCAGCC -> CACGCATAGCCTGTCCGGCAGCCT
CATATTGCCATAATTTACAATTAT -> ATATTGCCATAATTTACAATTATT
GATTTATCCCAATCTTGTGCTTAA -> ATTTATCCCAATCTTGTGCTTAAA
GACCAGTACGTATCTCTACTCGTG -> ACCAGTACGTATCTCTACTCGTGA
CACGTGAAACGGTTCTCTGAGGGA -> ACGTGAAACGGTTCTCTGAGGGAT
AAATAGATGGGGCCTAGTGGTCTA -> AATAGATGGGGCCTAGTGGTCTAA
ATACGCGATACCTAGGCTGAACGG -> TACGCGATACCTAGGCTGAACGGC
CTATGCTAGGCACGCACTAGACCG -> TATGCTAGGCACGCACTAGACCGC
GAGTTATCAGGTCCATGCAGAATC -> AGTTATCAGGTCCATGCAGAATCC
AGTGGAAGGGGTGTCTCCCCGATA -> GTGGAAGGGGTGTCTCCCCGATAT
ACCAAACCCCCACCCGGCTGATTC -> CCAAACCCCCACCCGGCTGATTCT
GTCTTGGTGTGCATAGGACCAGTA -> TCTTGGTGTGCATAGGACCAGTAC
ACTCGTGAAGGTCAGAAGCCATAG -> CTCGTGAAGGTCAGAAGCCATAGA
CCGAGTGTGTTAGACCGGTTCCGG -> CGAGTGTGTTAGACCGGTTCCGGA
AGCTGGGAACGACGCCTAAGACAA -> GCTGGGAACGACGCCTAAGACAAC
GCCATAATTTACAATTATTTACTT -> CCATAATTTACAATTATTTACTTG
TAGTACCCGAGAGGATAATTCGAT -> AGTACCCGAGAGGATAATTCGATG
CAAGAGGCAATCGACGAGCGATCT -> AAGAGGCAATCGACGAGCGATCTA
AGTACATTTCAGCGTCAGTATCCT -> GTACATTTCAGCGTCAGTATCCTA
AGCTGCGAGGCGCTGTACACCCTT -> GCTGCGAGGCGCTGTACACCCTTC
CTTTATCCTAATGCCTATGCTAGG -> TTTATCCTAATGCCTATGCTAGGC
GAATCGACGCTCACACGCATAGCC -> AATCGACGCTCACACGCATAGCCT
CGGATTCCCTAGACTACGTCGACT -> GGATTCCCTAGACTACGTCGACTG
ACGCACTAGACCGCTAATCGCGCG -> CGCACTAGACCGCTAATCGCGCGA
AATCTCCGTGGACGACGCGAGCGA -> ATCTCCGTGGACGACGCGAGCGAC
TCCAGCCGAATCTCCGTGGACGAC -> CCAGCCGAATCTCCGTGGACGACG
TGTCGCCAGACCAAGAACAAACTT -> GTCGCCAGACCAAGAACAAACTTC
CAGAGTAATCGTTTTGGATATCTG -> AGAGTAATCGTTTTGGATATCTGT
GGGCTCCATTGCACCGCGACAATC -> GGCTCCATTGCACCGCGACAATCT
AGCCTTGAGGTGCGACTTGTTCTT -> GCCTTGAGGTGCGACTTGTTCTTA
CTTCCTTGGATGCCAGTCGGACGG -> TTCCTTGGATGCCAGTCGGACGGG
CATGATACCTTCGTGGTCCGAGCC -> ATGATACCTTCGTGGTCCGAGCCT
TGCGATGTAGACATTTTAGACTAT -> GCGATGTAGACATTTTAGACTATG
ATATGAGACTAACAGTTGTTTAGA -> TATGAGACTAACAGTTGTTTAGAT
GCTTGATTTCGAAACTGGCATGCA -> CTTGATTTCGAAACTGGCATGCAC
GAGCTGGGAACGACGCCTAAGACA -> AGCTGGGAACGACGCCTAAGACAA
TTGACAACCTGAAGACGGGCGTGT -> TGACAACCTGAAGACGGGCGTGTA
ATAATTTACAATTATTTACTTGAT -> TAATTTACAATTATTTACTTGATA
ACTTGTTCTTAAGACGCTAATTAA -> CTTGTTCTTAAGACGCTAATTAAT
GAATACCTCATCGGGGTGACGCAC -> AATACCTCATCGGGGTGACGCACT
GGTGTGCATAGGACCAGTACGTAT -> GTGTGCATAGGACCAGTACGTATC
GTCGCGAGGAATACCTCATCGGGG -> TCGCGAGGAATACCTCATCGGGGT
ATCGACGAGCGATCTACAAAGTTA -> TCGACGAGCGATCTACAAAGTTAA
CAGTGTCGCCAGACCAAGAACAAA -> AGTGTCGCCAGACCAAGAACAAAC
TATCCCAATCTTGTGCTTAAATCA -> ATCCCAATCTTGTGCTTAAATCAT
GACCAAGAACAAACTTCCTTGGAT -> ACCAAGAACAAACTTCCTTGGATG
CAAGTGGCTTGATAATGGAATATA -> AAGTGGCTTGATAATGGAATATAC
GATCACTGCCTCGCGGTCTATGCT -> ATCACTGCCTCGCGGTCTATGCTC
TGGCAACAGAGGCGAACCCCGTTC -> GGCAACAGAGGCGAACCCCGTTCT
ATCGCGCGAACTTCGTAGGTAACC -> TCGCGCGAACTTCGTAGGTAACCA
GGAGTGAGAGAGCGTCATAGACCG -> GAGTGAGAGAGCGTCATAGACCGC
CCGTTGCCTAGCAGCATGTGTGGA -> CGTTGCCTAGCAGCATGTGTGGAA
GCCGAGTCAGTCGGTAACACATAC -> CCGAGTCAGTCGGTAACACATACT
AGCCGCTTACCCTTTCGCATGCGA -> GCCGCTTACCCTTTCGCATGCGAG
CAATGTGTTAGTGGAAGGGGTGTC -> AATGTGTTAGTGGAAGGGGTGTCT
GTGATGCCCCTTCCACTTAATCGT -> TGATGCCCCTTCCACTTAATCGTC
CCTCAGCCTGGACACTGAACCTGG -> CTCAGCCTGGACACTGAACCTGGC
GTTTAAGATCTGAGTACCTATTCA -> TTTAAGATCTGAGTACCTATTCAT
GGCCTAGTGGTCTAAGAGTCGCGA -> GCCTAGTGGTCTAAGAGTCGCGAG
AGACGGGCAGTGTGGCTAATCGCT -> GACGGGCAGTGTGGCTAATCGCTC
CTGTGCGATGTAGACATTTTAGAC -> TGTGCGATGTAGACATTTTAGACT
GACTATGCTTTAGGTCCGAGCTTT -> ACTATGCTTTAGGTCCGAGCTTTA
GCGACTTGTTCTTAAGACGCTAAT -> CGACTTGTTCTTAAGACGCTAATT
CGCGGTCTATGCTCTTGCTTTTAC -> GCGGTCTATGCTCTTGCTTTTACG
TCTCTACTCGTGAAGGTCAGAAGC -> CTCTACTCGTGAAGGTCAGAAGCC
GTGCCACGTGAAACGGTTCTCTGA -> TGCCACGTGAAACGGTTCTCTGAG
CCCCACCCGGCTGATTCTGCATAT -> CCCACCCGGCTGATTCTGCATATT
TAGCCGCTTACCCTTTCGCATGCG -> AGCCGCTTACCCTTTCGCATGCGA
ATAATTCGATGTTATGTTAGCGAA -> TAATTCGATGTTATGTTAGCGAAT
AGAATCCATACGCGATACCTAGGC -> GAATCCATACGCGATACCTAGGCT
AATGGAATATACGAGACACAAGAG -> ATGGAATATACGAGACACAAGAGG
AGGCTGAACGGCCCAGATATAGTG -> GGCTGAACGGCCCAGATATAGTGG
CCGGCAGCCTTCCTAATTTTTTAG -> CGGCAGCCTTCCTAATTTTTTAGC
ATGCTTTAGGTCCGAGCTTTACCC -> TGCTTTAGGTCCGAGCTTTACCCG
CCAAGAACAAACTTCCTTGGATGC -> CAAGAACAAACTTCCTTGGATGCC
TCGACTGTAGACGGGCAGTGTGGC -> CGACTGTAGACGGGCAGTGTGGCT
ACGAGACACAAGAGGCAATCGACG -> CGAGACACAAGAGGCAATCGACGA
TTAGAGGTAAAACGCCGGCGTTAT -> TAGAGGTAAAACGCCGGCGTTATT
ACAATTACTCGGGTTGCGAATCTG -> CAATTACTCGGGTTGCGAATCTGA
GCCTGTCCGGCAGCCTTCCTAATT -> CCTGTCCGGCAGCCTTCCTAATTT
CTTGATATCTACGTGGGACCGACA -> TTGATATCTACGTGGGACCGACAA
TAATATCCTCTTTACGTCACATGA -> AATATCCTCTTTACGTCACATGAC
AGGCTGTTGACAACCTGAAGACGG -> GGCTGTTGACAACCTGAAGACGGG
GAGGAATACCTCATCGGGGTGACG -> AGGAATACCTCATCGGGGTGACGC
GGGATGTCACACGTGGATACCTGC -> GGATGTCACACGTGGATACCTGCT
AATTGGTCCGTGGTTGCAACGCCC -> ATTGGTCCGTGGTTGCAACGCCCC
GTCCATGCTAGAGAGTCAGTACAT -> TCCATGCTAGAGAGTCAGTACATT
TTGAATGTATTACGTTTGCTAGAA -> TGAATGTATTACGTTTGCTAGAAG
CTATAAAGATACTTGTGTTGACAA -> TATAAAGATACTTGTGTTGACAAT
GACTTGTTCTTAAGACGCTAATTA -> ACTTGTTCTTAAGACGCTAATTAA
CCATTGCACCGCGACAATCTGCAG -> CATTGCACCGCGACAATCTGCAGT
TAAGTCCTCAGCCTGGACACTGAA -> AAGTCCTCAGCCTGGACACTGAAC
GAAGGGGTGTCTCCCCGATATAGA -> AAGGGGTGTCTCCCCGATATAGAG
GTTGCAACGCCCCTCTTGAGCGGG -> TTGCAACGCCCCTCTTGAGCGGGC
TGGGGCTACCAGAGCAGTGCCCCC -> GGGGCTACCAGAGCAGTGCCCCCC
TGCTTTAGGTCCGAGCTTTACCCG -> GCTTTAGGTCCGAGCTTTACCCGT
GGCTACCTGGCAACAGAGGCGAAC -> GCTACCTGGCAACAGAGGCGAACC
GGTTGCGAATCTGAACAATGGCAA -> GTTGCGAATCTGAACAATGGCAAG
CCTTCGTGGTCCGAGCCTTGAGGT -> CTTCGTGGTCCGAGCCTTGAGGTG
TACCCTTTCGCATGCGAGTTATCA -> ACCCTTTCGCATGCGAGTTATCAG
CTCGCCCGAGAGTCACTATGGGAT -> TCGCCCGAGAGTCACTATGGGATG
AGCGATCTACAAAGTTAACTGGGC -> GCGATCTACAAAGTTAACTGGGCG
TCCCTAGACTACGTCGACTGTAGA -> CCCTAGACTACGTCGACTGTAGAC
GTGGCTAATCGCTCCCTGATCCGA -> TGGCTAATCGCTCCCTGATCCGAC
AGAGTCACTATGGGATGTATCGAT -> GAGTCACTATGGGATGTATCGATA
TTTTAGACTATGCTTTAGGTCCGA -> TTTAGACTATGCTTTAGGTCCGAG
GTCTAGAGATCACTACCAAGGTGC -> TCTAGAGATCACTACCAAGGTGCC
CGCATTGAATGTATTACGTTTGCT -> GCATTGAATGTATTACGTTTGCTA
AGTGTGGCTAATCGCTCCCTGATC -> GTGTGGCTAATCGCTCCCTGATCC
CCAGCAGTTGTCTGTTTATAAAGG -> CAGCAGTTGTCTGTTTATAAAGGG
CAAGAACAATGTGTTAGTGGAAGG -> AAGAACAATGTGTTAGTGGAAGGG
CTTAAATCATGAACATACGCCCCT -> TTAAATCATGAACATACGCCCCTC
AATAGGCTACTATGTGACTTTCGG -> ATAGGCTACTATGTGACTTTCGGG
ACCATTTGCAAGAACAATGTGTTA -> CCATTTGCAAGAACAATGTGTTAG
TGGTTGCAACGCCCCTCTTGAGCG -> GGTTGCAACGCCCCTCTTGAGCGG
ACGCGAGCGACTATAGTTCCCTCG -> CGCGAGCGACTATAGTTCCCTCGC
ATCTGTGGGTAGCAGCCAGAAGGG -> TCTGTGGGTAGCAGCCAGAAGGGC
TCTAAGAGTCGCGAGGAATACCTC -> CTAAGAGTCGCGAGGAATACCTCA
TCCTCAGCCTGGACACTGAACCTG -> CCTCAGCCTGGACACTGAACCTGG
GAATCCATACGCGATACCTAGGCT -> AATCCATACGCGATACCTAGGCTG
CCTTGCGGGATGTCACACGTGGAT -> CTTGCGGGATGTCACACGTGGATA
TGCACCAGGATACGCTTAGAGGTA -> GCACCAGGATACGCTTAGAGGTAA
TGAGGTGCGACTTGTTCTTAAGAC -> GAGGTGCGACTTGTTCTTAAGACG
GCGATACCTAGGCTGAACGGCCCA -> CGATACCTAGGCTGAACGGCCCAG
TCATCGGGGTGACGCACTAATATG -> CATCGGGGTGACGCACTAATATGA
GTCTAAGAGTCGCGAGGAATACCT -> TCTAAGAGTCGCGAGGAATACCTC
CCTTTCGCATGCGAGTTATCAGGT -> CTTTCGCATGCGAGTTATCAGGTC
GAAACTCAGCACCAGGTCTTGGTG -> AAACTCAGCACCAGGTCTTGGTGT
CGCAACTATTGATTAGATCATCAG -> GCAACTATTGATTAGATCATCAGG
GTGCAGCGGAGCTGGGAACGACGC -> TGCAGCGGAGCTGGGAACGACGCC
AAGAGGCAATCGACGAGCGATCTA -> AGAGGCAATCGACGAGCGATCTAC
CATGGCGGTCAACGTACGCAGGGG -> ATGGCGGTCAACGTACGCAGGGGT
TCTACAAAGTTAACTGGGCGAGCT -> CTACAAAGTTAACTGGGCGAGCTG
TAGACTAGATCATTAATATCCTCT -> AGACTAGATCATTAATATCCTCTT
GGAAGGGGTGTCTCCCCGATATAG -> GAAGGGGTGTCTCCCCGATATAGA
GCTAGGAACGTCCTCGAGAGACCA -> CTAGGAACGTCCTCGAGAGACCAA
TTGACAATTACTCGGGTTGCGAAT -> TGACAATTACTCGGGTTGCGAATC
CCGCAATTGGTCCGTGGTTGCAAC -> CGCAATTGGTCCGTGGTTGCAACG
TGTGTTGACAATTACTCGGGTTGC -> GTGTTGACAATTACTCGGGTTGCG
GACTAACAGTTGTTTAGATATAGA -> ACTAACAGTTGTTTAGATATAGAA
AGATACTTGTGTTGACAATTACTC -> GATACTTGTGTTGACAATTACTCG
TAGACTATGCTTTAGGTCCGAGCT -> AGACTATGCTTTAGGTCCGAGCTT
CCCTGACACTCTTAGTGCCGGGTT -> CCTGACACTCTTAGTGCCGGGTTC
TGTTAGACCGGTTCCGGAAACTAG -> GTTAGACCGGTTCCGGAAACTAGA
GTGTCGCCAGACCAAGAACAAACT -> TGTCGCCAGACCAAGAACAAACTT
CAATCTTGTGCTTAAATCATGAAC -> AATCTTGTGCTTAAATCATGAACA
GTTGCGAATCTGAACAATGGCAAG -> TTGCGAATCTGAACAATGGCAAGC
CATTCTCGTTACGAACAGAGTAAT -> ATTCTCGTTACGAACAGAGTAATC
TTTATCCCAATCTTGTGCTTAAAT -> TTATCCCAATCTTGTGCTTAAATC
CCGATTTATCCCAATCTTGTGCTT -> CGATTTATCCCAATCTTGTGCTTA
CAAACTTCCTTGGATGCCAGTCGG -> AAACTTCCTTGGATGCCAGTCGGA
GAAGCCATAGAGTTTAAGATCTGA -> AAGCCATAGAGTTTAAGATCTGAG
TGACGATCCTGCCCAGATTGGGGC -> GACGATCCTGCCCAGATTGGGGCG
GATAATGGAATATACGAGACACAA -> ATAATGGAATATACGAGACACAAG
TGCTTTTACGCGGACTCCTATAAT -> GCTTTTACGCGGACTCCTATAATA
GTGATCACTGCCTCGCGGTCTATG -> TGATCACTGCCTCGCGGTCTATGC
ATAGCCTGTCCGGCAGCCTTCCTA -> TAGCCTGTCCGGCAGCCTTCCTAA
GGCTTGATAATGGAATATACGAGA -> GCTTGATAATGGAATATACGAGAC
CGCGGACTCCTATAATAAAAATCC -> GCGGACTCCTATAATAAAAATCCT
AGGTATAGCTCGTTGAACTGTCAC -> GGTATAGCTCGTTGAACTGTCACG
GTTAGCGAATTGTGCCTTTAGGCT -> TTAGCGAATTGTGCCTTTAGGCTG
CGACGAGCGATCTACAAAGTTAAC -> GACGAGCGATCTACAAAGTTAACT
GCCGGGTTCTTCGGTTGGCCTTTC -> CCGGGTTCTTCGGTTGGCCTTTCG
GGCTACTATGTGACTTTCGGGTCT -> GCTACTATGTGACTTTCGGGTCTT
GCAATTGGTCCGTGGTTGCAACGC -> CAATTGGTCCGTGGTTGCAACGCC
CGAGAGACCAAACCCCCACCCGGC -> GAGAGACCAAACCCCCACCCGGCT
TAAAACGCCGGCGTTATTAGCAGG -> AAAACGCCGGCGTTATTAGCAGGG
ATCATTAATATCCTCTTTACGTCA -> TCATTAATATCCTCTTTACGTCAC
GACCGTTGCCTAGCAGCATGTGTG -> ACCGTTGCCTAGCAGCATGTGTGG
CAAGCTACATTGTGTGGTGATGCC -> AAGCTACATTGTGTGGTGATGCCC
GCTGTTGACAACCTGAAGACGGGC -> CTGTTGACAACCTGAAGACGGGCG
AGCCCTGACACTCTTAGTGCCGGG -> GCCCTGACACTCTTAGTGCCGGGT
GGTAACCATTATGTGTGATCACTG -> GTAACCATTATGTGTGATCACTGC
ATGCTAGGCACGCACTAGACCGCT -> TGCTAGGCACGCACTAGACCGCTA
GACGGGAGTTGGCGGATTCCCTAG -> ACGGGAGTTGGCGGATTCCCTAGA
TATCCTATAAAGATACTTGTGTTG -> ATCCTATAAAGATACTTGTGTTGA
CTAGTGGTCTAAGAGTCGCGAGGA -> TAGTGGTCTAAGAGTCGCGAGGAA
GACCGACAAGTGGCTTGATAATGG -> ACCGACAAGTGGCTTGATAATGGA
CTTAGAGGTAAAACGCCGGCGTTA -> TTAGAGGTAAAACGCCGGCGTTAT
ACGCCTAAGACAACGGCACTATCG -> CGCCTAAGACAACGGCACTATCGG
CATGCAGAATCCATACGCGATACC -> ATGCAGAATCCATACGCGATACCT
GAGAGTCACTATGGGATGTATCGA -> AGAGTCACTATGGGATGTATCGAT
GGGCCTAGTGGTCTAAGAGTCGCG -> GGCCTAGTGGTCTAAGAGTCGCGA
CTGTGGGTAGCAGCCAGAAGGGCT -> TGTGGGTAGCAGCCAGAAGGGCTA
AACGTCCTCGAGAGACCAAACCCC -> ACGTCCTCGAGAGACCAAACCCCC
ATAGGACCAGTACGTATCTCTACT -> TAGGACCAGTACGTATCTCTACTC
TAGCGCAACTATTGATTAGATCAT -> AGCGCAACTATTGATTAGATCATC
GACGCACTAATATGAGACTAACAG -> ACGCACTAATATGAGACTAACAGT
GTCCGTGGTTGCAACGCCCCTCTT -> TCCGTGGTTGCAACGCCCCTCTTG
ATACCTTCGTGGTCCGAGCCTTGA -> TACCTTCGTGGTCCGAGCCTTGAG
CACGCACTAGACCGCTAATCGCGC -> ACGCACTAGACCGCTAATCGCGCG
TTATCCTAATGCCTATGCTAGGCA -> TATCCTAATGCCTATGCTAGGCAC
TCGTGGTCCGAGCCTTGAGGTGCG -> CGTGGTCCGAGCCTTGAGGTGCGA
TTCCTAATTTTTTAGCGCAACTAT -> TCCTAATTTTTTAGCGCAACTATT
GGGTGTCTCCCCGATATAGAGCAT -> GGTGTCTCCCCGATATAGAGCATT
GTGACTAAGTCCTCAGCCTGGACA -> TGACTAAGTCCTCAGCCTGGACAC
TCCTAATTTTTTAGCGCAACTATT -> CCTAATTTTTTAGCGCAACTATTG
AGACCAAACCCCCACCCGGCTGAT -> GACCAAACCCCCACCCGGCTGATT
AAAAATAGATGGGGCCTAGTGGTC -> AAAATAGATGGGGCCTAGTGGTCT
ATCGTCCCTATAGCCCTGACACTC -> TCGTCCCTATAGCCCTGACACTCT
CTCGTGAAGGTCAGAAGCCATAGA -> TCGTGAAGGTCAGAAGCCATAGAG
ATAATAAAAATCCTTTGTATCAAA -> TAATAAAAATCCTTTGTATCAAAA
CCCGTAGTTAAAAATGTGGCCCCT -> CCGTAGTTAAAAATGTGGCCCCTG
ATCGTTTTGGATATCTGTGGGTAG -> TCGTTTTGGATATCTGTGGGTAGC
GGGCTAATTAGCCGGAAAAGGCGA -> GGCTAATTAGCCGGAAAAGGCGAC
CGAAACTGGCATGCACCAGGATAC -> GAAACTGGCATGCACCAGGATACG
CGTTACGAACAGAGTAATCGTTTT -> GTTACGAACAGAGTAATCGTTTTG
TATGCTTTAGGTCCGAGCTTTACC -> ATGCTTTAGGTCCGAGCTTTACCC
ACCTGGCAACAGAGGCGAACCCCG -> CCTGGCAACAGAGGCGAACCCCGT
GTGGTTGCAACGCCCCTCTTGAGC -> TGGTTGCAACGCCCCTCTTGAGCG
GCGAATTGTGCCTTTAGGCTGTTG -> CGAATTGTGCCTTTAGGCTGTTGA
TATAGCCCTGACACTCTTAGTGCC -> ATAGCCCTGACACTCTTAGTGCCG
GATACTTGTGTTGACAATTACTCG -> ATACTTGTGTTGACAATTACTCGG
AAGTTAACTGGGCGAGCTGCGAGG -> AGTTAACTGGGCGAGCTGCGAGGC
AACCTGAAGACGGGCGTGTAGCCC -> ACCTGAAGACGGGCGTGTAGCCCG
TCGCTCGCCCGAGAGTCACTATGG -> CGCTCGCCCGAGAGTCACTATGGG
ACTCTTGTAGCCGCTTACCCTTTC -> CTCTTGTAGCCGCTTACCCTTTCG
GGTCCGTGGTTGCAACGCCCCTCT -> GTCCGTGGTTGCAACGCCCCTCTT
CCCTGTGACGATCCTGCCCAGATT -> CCTGTGACGATCCTGCCCAGATTG
TCGGTAACACATACTCGCTTTCAG -> CGGTAACACATACTCGCTTTCAGT
TGCACCGCGACAATCTGCAGTGTC -> GCACCGCGACAATCTGCAGTGTCG
GCCCCTCCCTTGCGGGATGTCACA -> CCCCTCCCTTGCGGGATGTCACAC
TGAGACTAACAGTTGTTTAGATAT -> GAGACTAACAGTTGTTTAGATATA
CTATTGATTAGATCATCAGGTATA -> TATTGATTAGATCATCAGGTATAG
TAGCAGCCAGAAGGGCTAATTAGC -> AGCAGCCAGAAGGGCTAATTAGCC
CTCCCGAGTGTGTTAGACCGGTTC -> TCCCGAGTGTGTTAGACCGGTTCC
CAAACCCCCACCCGGCTGATTCTG -> AAACCCCCACCCGGCTGATTCTGC
AGAGACCAAACCCCCACCCGGCTG -> GAGACCAAACCCCCACCCGGCTGA
ATTGGGGCGCTCCCCCTTGAAGAT -> TTGGGGCGCTCCCCCTTGAAGATC
ATAGAGCATTCTCGTTACGAACAG -> TAGAGCATTCTCGTTACGAACAGA
CTGGGAACGACGCCTAAGACAACG -> TGGGAACGACGCCTAAGACAACGG
ACCCCGTTCTCCCGAGTGTGTTAG -> CCCCGTTCTCCCGAGTGTGTTAGA
AGAGTCAGTACATTTCAGCGTCAG -> GAGTCAGTACATTTCAGCGTCAGT
GGTCTTGGTGTGCATAGGACCAGT -> GTCTTGGTGTGCATAGGACCAGTA
TGCAAGAACAATGTGTTAGTGGAA -> GCAAGAACAATGTGTTAGTGGAAG
CCCACCCGGCTGATTCTGCATATT -> CCACCCGGCTGATTCTGCATATTG
CTAAGTCCTCAGCCTGGACACTGA -> TAAGTCCTCAGCCTGGACACTGAA
CTAGCAGCATGTGTGGAAGTGAAC -> TAGCAGCATGTGTGGAAGTGAACG
CGAGAGGATAATTCGATGTTATGT -> GAGAGGATAATTCGATGTTATGTT
AAAAGGCGACGAGAAAATACTCTT -> AAAGGCGACGAGAAAATACTCTTG
GAGCGGGCTCCATTGCACCGCGAC -> AGCGGGCTCCATTGCACCGCGACA
TTGCTTTTACGCGGACTCCTATAA -> TGCTTTTACGCGGACTCCTATAAT
GTACACCCTTCTAATTGCGGTGGG -> TACACCCTTCTAATTGCGGTGGGG
TCTATGCTCTTGCTTTTACGCGGA -> CTATGCTCTTGCTTTTACGCGGAC
GAGCTGCGAGGCGCTGTACACCCT -> AGCTGCGAGGCGCTGTACACCCTT
CGAGAGTCACTATGGGATGTATCG -> GAGAGTCACTATGGGATGTATCGA
CGGGCGTGTAGCCCGACTGAACAG -> GGGCGTGTAGCCCGACTGAACAGG
TTGCGAATCTGAACAATGGCAAGC -> TGCGAATCTGAACAATGGCAAGCT
GGCCCAGATATAGTGGTCCATGCT -> GCCCAGATATAGTGGTCCATGCTA
AGTAATCGTTTTGGATATCTGTGG -> GTAATCGTTTTGGATATCTGTGGG
TACATTTCAGCGTCAGTATCCTAT -> ACATTTCAGCGTCAGTATCCTATA
CGGGCAGTGTGGCTAATCGCTCCC -> GGGCAGTGTGGCTAATCGCTCCCT
TAATCGCGCGAACTTCGTAGGTAA -> AATCGCGCGAACTTCGTAGGTAAC
GGTTGGCCTTTCGCATTGAATGTA -> GTTGGCCTTTCGCATTGAATGTAT
CATTGCACCGCGACAATCTGCAGT -> ATTGCACCGCGACAATCTGCAGTG
TCCCAATCTTGTGCTTAAATCATG -> CCCAATCTTGTGCTTAAATCATGA
TGTCGGTCTAGAGATCACTACCAA -> GTCGGTCTAGAGATCACTACCAAG
AATCGCTCCCTGATCCGACTCGTG -> ATCGCTCCCTGATCCGACTCGTGA
GGTCCGAGCCTTGAGGTGCGACTT -> GTCCGAGCCTTGAGGTGCGACTTG
TCTAATTGCGGTGGGGCTACCAGA -> CTAATTGCGGTGGGGCTACCAGAG
GGCTTATCGGCCCTCGGAAAACCG -> GCTTATCGGCCCTCGGAAAACCGC
TTTGGATATCTGTGGGTAGCAGCC -> TTGGATATCTGTGGGTAGCAGCCA
CCATAGAGTTTAAGATCTGAGTAC -> CATAGAGTTTAAGATCTGAGTACC
ACCGGTTCCGGAAACTAGACTAGA -> CCGGTTCCGGAAACTAGACTAGAT
CTTGCGGGATGTCACACGTGGATA -> TTGCGGGATGTCACACGTGGATAC
GCGGGCTCCATTGCACCGCGACAA -> CGGGCTCCATTGCACCGCGACAAT
GGCGGATTCCCTAGACTACGTCGA -> GCGGATTCCCTAGACTACGTCGAC
GTTTATAAAGGGCTACCTGGCAAC -> TTTATAAAGGGCTACCTGGCAACA
ATTGATTAGATCATCAGGTATAGC -> TTGATTAGATCATCAGGTATAGCT
GAGGATAATTCGATGTTATGTTAG -> AGGATAATTCGATGTTATGTTAGC
GGATACGCTTAGAGGTAAAACGCC -> GATACGCTTAGAGGTAAAACGCCG
TGATAATGGAATATACGAGACACA -> GATAATGGAATATACGAGACACAA
TGGCTAATCGCTCCCTGATCCGAC -> GGCTAATCGCTCCCTGATCCGACT
AATCGACGAGCGATCTACAAAGTT -> ATCGACGAGCGATCTACAAAGTTA
ACGGGCGTGTAGCCCGACTGAACA -> CGGGCGTGTAGCCCGACTGAACAG
GCCTAGTGGTCTAAGAGTCGCGAG -> CCTAGTGGTCTAAGAGTCGCGAGG
TCGCGCGAACTTCGTAGGTAACCA -> CGCGCGAACTTCGTAGGTAACCAT
AGACGGGCGTGTAGCCCGACTGAA -> GACGGGCGTGTAGCCCGACTGAAC
GAAGGTCAGAAGCCATAGAGTTTA -> AAGGTCAGAAGCCATAGAGTTTAA
CGAGCTGCGAGGCGCTGTACACCC -> GAGCTGCGAGGCGCTGTACACCCT
ACCAGAGCAGTGCCCCCCAATAGG -> CCAGAGCAGTGCCCCCCAATAGGC
ACACGTGGATACCTGCTCCCTTGG -> CACGTGGATACCTGCTCCCTTGGC
TATGTGTGATCACTGCCTCGCGGT -> ATGTGTGATCACTGCCTCGCGGTC
TACGCCCCTCCCTTGCGGGATGTC -> ACGCCCCTCCCTTGCGGGATGTCA
TATTAGCAGGGTCTCCTATAGCGC -> ATTAGCAGGGTCTCCTATAGCGCC
ATCACTGCCTCGCGGTCTATGCTC -> TCACTGCCTCGCGGTCTATGCTCT
GCCCTGACACTCTTAGTGCCGGGT -> CCCTGACACTCTTAGTGCCGGGTT
ACGAGCGATCTACAAAGTTAACTG -> CGAGCGATCTACAAAGTTAACTGG
TAGGCTGAACGGCCCAGATATAGT -> AGGCTGAACGGCCCAGATATAGTG
ATGTGTTAGTGGAAGGGGTGTCTC -> TGTGTTAGTGGAAGGGGTGTCTCC
ACTGAACAGGGCCGATTTATCCCA -> CTGAACAGGGCCGATTTATCCCAA
AGTCGGACGGGAGTTGGCGGATTC -> GTCGGACGGGAGTTGGCGGATTCC
AAAGATACTTGTGTTGACAATTAC -> AAGATACTTGTGTTGACAATTACT
TTACGTTTGCTAGAAGCGTGCAGC -> TACGTTTGCTAGAAGCGTGCAGCG
GGTAGCAGCCAGAAGGGCTAATTA -> GTAGCAGCCAGAAGGGCTAATTAG
CCTGAAGACGGGCGTGTAGCCCGA -> CTGAAGACGGGCGTGTAGCCCGAC
TCTGAACAATGGCAAGCTACATTG -> CTGAACAATGGCAAGCTACATTGT
GCTTTCAGTGCTAGGAACGTCCTC -> CTTTCAGTGCTAGGAACGTCCTCG
CTTAGTGCCGGGTTCTTCGGTTGG -> TTAGTGCCGGGTTCTTCGGTTGGC
ATAGATGGGGCCTAGTGGTCTAAG -> TAGATGGGGCCTAGTGGTCTAAGA
TTTACGTCACATGACCGTTGCCTA -> TTACGTCACATGACCGTTGCCTAG
CGCTTTCAGTGCTAGGAACGTCCT -> GCTTTCAGTGCTAGGAACGTCCTC
ACAAGAGGCAATCGACGAGCGATC -> CAAGAGGCAATCGACGAGCGATCT
GGGCGAGCTGCGAGGCGCTGTACA -> GGCGAGCTGCGAGGCGCTGTACAC
TCGGTCTAGAGATCACTACCAAGG -> CGGTCTAGAGATCACTACCAAGGT
GTTTTGGATATCTGTGGGTAGCAG -> TTTTGGATATCTGTGGGTAGCAGC
ACTGCCTCGCGGTCTATGCTCTTG -> CTGCCTCGCGGTCTATGCTCTTGC
AGGTGCCACGTGAAACGGTTCTCT -> GGTGCCACGTGAAACGGTTCTCTG
CACCGCGACAATCTGCAGTGTCGC -> ACCGCGACAATCTGCAGTGTCGCC
GGGAACGACGCCTAAGACAACGGC -> GGAACGACGCCTAAGACAACGGCA
GCCAGTCGGACGGGAGTTGGCGGA -> CCAGTCGGACGGGAGTTGGCGGAT
CTTGTGTTGACAATTACTCGGGTT -> TTGTGTTGACAATTACTCGGGTTG
AGCTCGTTGAACTGTCACGTAATT -> GCTCGTTGAACTGTCACGTAATTT
GGTCTAGAGATCACTACCAAGGTG -> GTCTAGAGATCACTACCAAGGTGC
AAGACAACGGCACTATCGGGCACC -> AGACAACGGCACTATCGGGCACCA
CATTTGCAAGAACAATGTGTTAGT -> ATTTGCAAGAACAATGTGTTAGTG
GGTTCCGGAAACTAGACTAGATCA -> GTTCCGGAAACTAGACTAGATCAT
GCTCGCCCGAGAGTCACTATGGGA -> CTCGCCCGAGAGTCACTATGGGAT
AACATACGCCCCTCCCTTGCGGGA -> ACATACGCCCCTCCCTTGCGGGAT
GAGGCGCTGTACACCCTTCTAATT -> AGGCGCTGTACACCCTTCTAATTG
TTATTAGCAGGGTCTCCTATAGCG -> TATTAGCAGGGTCTCCTATAGCGC
ACTATTGATTAGATCATCAGGTAT -> CTATTGATTAGATCATCAGGTATA
AAGGTGCCACGTGAAACGGTTCTC -> AGGTGCCACGTGAAACGGTTCTCT
ATGCAGAATCCATACGCGATACCT -> TGCAGAATCCATACGCGATACCTA
GCAACTATTGATTAGATCATCAGG -> CAACTATTGATTAGATCATCAGGT
ATAGAGTTTAAGATCTGAGTACCT -> TAGAGTTTAAGATCTGAGTACCTA
TGACCGTTGCCTAGCAGCATGTGT -> GACCGTTGCCTAGCAGCATGTGTG
GTGCTAGGAACGTCCTCGAGAGAC -> TGCTAGGAACGTCCTCGAGAGACC
AACACATACTCGCTTTCAGTGCTA -> ACACATACTCGCTTTCAGTGCTAG
TCCCTTGGCTTATCGGCCCTCGGA -> CCCTTGGCTTATCGGCCCTCGGAA
CGCATGCGAGTTATCAGGTCCATG -> GCATGCGAGTTATCAGGTCCATGC
AACGTACGCAGGGGTTGCCGAGTC -> ACGTACGCAGGGGTTGCCGAGTCA
CCTGGACACTGAACCTGGCTGTGC -> CTGGACACTGAACCTGGCTGTGCG
GGGCGTGTAGCCCGACTGAACAGG -> GGCGTGTAGCCCGACTGAACAGGG
GGAGCTGGGAACGACGCCTAAGAC -> GAGCTGGGAACGACGCCTAAGACA
CAGAGGCGAACCCCGTTCTCCCGA -> AGAGGCGAACCCCGTTCTCCCGAG
GACGAGCGATCTACAAAGTTAACT -> ACGAGCGATCTACAAAGTTAACTG
TGACACTCTTAGTGCCGGGTTCTT -> GACACTCTTAGTGCCGGGTTCTTC
GGTAAAACGCCGGCGTTATTAGCA -> GTAAAACGCCGGCGTTATTAGCAG
CAGTCGGACGGGAGTTGGCGGATT -> AGTCGGACGGGAGTTGGCGGATTC
AATCGCGCGAACTTCGTAGGTAAC -> ATCGCGCGAACTTCGTAGGTAACC
ATGATACCTTCGTGGTCCGAGCCT -> TGATACCTTCGTGGTCCGAGCCTT
GATACGCTTAGAGGTAAAACGCCG -> ATACGCTTAGAGGTAAAACGCCGG
TCTTAAGACGCTAATTAATAGTAC -> CTTAAGACGCTAATTAATAGTACC
TTAGGCTGTTGACAACCTGAAGAC -> TAGGCTGTTGACAACCTGAAGACG
AATATACGAGACACAAGAGGCAAT -> ATATACGAGACACAAGAGGCAATC
CAGCGGAGCTGGGAACGACGCCTA -> AGCGGAGCTGGGAACGACGCCTAA
CTATAGCGCCCTGTCGGTCTAGAG -> TATAGCGCCCTGTCGGTCTAGAGA
GTCCGAGCCTTGAGGTGCGACTTG -> TCCGAGCCTTGAGGTGCGACTTGT
TAGGCTGTTGACAACCTGAAGACG -> AGGCTGTTGACAACCTGAAGACGG
AGACTATGCTTTAGGTCCGAGCTT -> GACTATGCTTTAGGTCCGAGCTTT
AATCCTTTGTATCAAAAAATAGAT -> ATCCTTTGTATCAAAAAATAGATG
TGTCTGTTTATAAAGGGCTACCTG -> GTCTGTTTATAAAGGGCTACCTGG
GATATAGAAACTCAGCACCAGGTC -> ATATAGAAACTCAGCACCAGGTCT
TGGTGATGCCCCTTCCACTTAATC -> GGTGATGCCCCTTCCACTTAATCG
GTTCTTCGGTTGGCCTTTCGCATT -> TTCTTCGGTTGGCCTTTCGCATTG
CGACAAGTGGCTTGATAATGGAAT -> GACAAGTGGCTTGATAATGGAATA
CTACGTGGGACCGACAAGTGGCTT -> TACGTGGGACCGACAAGTGGCTTG
GCGTTATTAGCAGGGTCTCCTATA -> CGTTATTAGCAGGGTCTCCTATAG
TCGTGACTAAGTCCTCAGCCTGGA -> CGTGACTAAGTCCTCAGCCTGGAC
TAATCGTTTTGGATATCTGTGGGT -> AATCGTTTTGGATATCTGTGGGTA
TGTCACACGTGGATACCTGCTCCC -> GTCACACGTGGATACCTGCTCCCT
CTTAATCGTCCCTATAGCCCTGAC -> TTAATCGTCCCTATAGCCCTGACA
GAATCTGAACAATGGCAAGCTACA -> AATCTGAACAATGGCAAGCTACAT
GGATGTCACACGTGGATACCTGCT -> GATGTCACACGTGGATACCTGCTC
TGAACCTGGCTGTGCGATGTAGAC -> GAACCTGGCTGTGCGATGTAGACA
AACTGGCATGCACCAGGATACGCT -> ACTGGCATGCACCAGGATACGCTT
CTTCCACTTAATCGTCCCTATAGC -> TTCCACTTAATCGTCCCTATAGCC
GTTGCCGAGTCAGTCGGTAACACA -> TTGCCGAGTCAGTCGGTAACACAT
GCTCCCTTGGCTTATCGGCCCTCG -> CTCCCTTGGCTTATCGGCCCTCGG
AGACTAGATCATTAATATCCTCTT -> GACTAGATCATTAATATCCTCTTT
CCGACTCGTGACTAAGTCCTCAGC -> CGACTCGTGACTAAGTCCTCAGCC
CACGTAATTTCCAGCCGAATCTCC -> ACGTAATTTCCAGCCGAATCTCCG
CCTTGAGGTGCGACTTGTTCTTAA -> CTTGAGGTGCGACTTGTTCTTAAG
AAACTCAGCACCAGGTCTTGGTGT -> AACTCAGCACCAGGTCTTGGTGTG
TTAGGTCCGAGCTTTACCCGTAGT -> TAGGTCCGAGCTTTACCCGTAGTT
GCCGGCGTTATTAGCAGGGTCTCC -> CCGGCGTTATTAGCAGGGTCTCCT
GCCTAAGACAACGGCACTATCGGG -> CCTAAGACAACGGCACTATCGGGC
CGTATCTCTACTCGTGAAGGTCAG -> GTATCTCTACTCGTGAAGGTCAGA
TCCTATAGCGCCCTGTCGGTCTAG -> CCTATAGCGCCCTGTCGGTCTAGA
GTGAAACGGTTCTCTGAGGGATGC -> TGAAACGGTTCTCTGAGGGATGCG
TCGATACCACATGGCGGTCAACGT -> CGATACCACATGGCGGTCAACGTA
CGGGAGTTGGCGGATTCCCTAGAC -> GGGAGTTGGCGGATTCCCTAGACT
CGATGTAGACATTTTAGACTATGC -> GATGTAGACATTTTAGACTATGCT
TTAGCCGGAAAAGGCGACGAGAAA -> TAGCCGGAAAAGGCGACGAGAAAA
GTAGACATTTTAGACTATGCTTTA -> TAGACATTTTAGACTATGCTTTAG
TATGTTAGCGAATTGTGCCTTTAG -> ATGTTAGCGAATTGTGCCTTTAGG
TCAGTCGGTAACACATACTCGCTT -> CAGTCGGTAACACATACTCGCTTT
AGATCATCAGGTATAGCTCGTTGA -> GATCATCAGGTATAGCTCGTTGAA
TACTCGTGAAGGTCAGAAGCCATA -> ACTCGTGAAGGTCAGAAGCCATAG
GCCAGAAGGGCTAATTAGCCGGAA -> CCAGAAGGGCTAATTAGCCGGAAA
GAAGGGCTAATTAGCCGGAAAAGG -> AAGGGCTAATTAGCCGGAAAAGGC
CCCAGATATAGTGGTCCATGCTAG -> CCAGATATAGTGGTCCATGCTAGA
AGAGCGTCATAGACCGCACCATTT -> GAGCGTCATAGACCGCACCATTTG
CCGAGAGGATAATTCGATGTTATG -> CGAGAGGATAATTCGATGTTATGT
ATACCACATGGCGGTCAACGTACG -> TACCACATGGCGGTCAACGTACGC
ACGTGAAACGGTTCTCTGAGGGAT -> CGTGAAACGGTTCTCTGAGGGATG
CTCGAGAGACCAAACCCCCACCCG -> TCGAGAGACCAAACCCCCACCCGG
GCATAGGACCAGTACGTATCTCTA -> CATAGGACCAGTACGTATCTCTAC
CGAACCCCGTTCTCCCGAGTGTGT -> GAACCCCGTTCTCCCGAGTGTGTT
ATCGACGCTCACACGCATAGCCTG -> TCGACGCTCACACGCATAGCCTGT
ATGCTCTTGCTTTTACGCGGACTC -> TGCTCTTGCTTTTACGCGGACTCC
TAGGCACGCACTAGACCGCTAATC -> AGGCACGCACTAGACCGCTAATCG
TCGGACGGGAGTTGGCGGATTCCC -> CGGACGGGAGTTGGCGGATTCCCT
TGGAATATACGAGACACAAGAGGC -> GGAATATACGAGACACAAGAGGCA
GGTCTTTATCCTAATGCCTATGCT -> GTCTTTATCCTAATGCCTATGCTA
CGTCACATGACCGTTGCCTAGCAG -> GTCACATGACCGTTGCCTAGCAGC
ACAAACTTCCTTGGATGCCAGTCG -> CAAACTTCCTTGGATGCCAGTCGG
TCCGGCAGCCTTCCTAATTTTTTA -> CCGGCAGCCTTCCTAATTTTTTAG
TACGTATCTCTACTCGTGAAGGTC -> ACGTATCTCTACTCGTGAAGGTCA
CTCCCTGATCCGACTCGTGACTAA -> TCCCTGATCCGACTCGTGACTAAG
AGAGCAGTGCCCCCCAATAGGCTA -> GAGCAGTGCCCCCCAATAGGCTAC
GCGAACTTCGTAGGTAACCATTAT -> CGAACTTCGTAGGTAACCATTATG
CCCTCCCTTGCGGGATGTCACACG -> CCTCCCTTGCGGGATGTCACACGT
GACTCCTATAATAAAAATCCTTTG -> ACTCCTATAATAAAAATCCTTTGT
CCGGAAAAGGCGACGAGAAAATAC -> CGGAAAAGGCGACGAGAAAATACT
TTGATAATGGAATATACGAGACAC -> TGATAATGGAATATACGAGACACA
ACTCTTAGTGCCGGGTTCTTCGGT -> CTCTTAGTGCCGGGTTCTTCGGTT
GGAACGTCCTCGAGAGACCAAACC -> GAACGTCCTCGAGAGACCAAACCC
TGGCTGTGCGATGTAGACATTTTA -> GGCTGTGCGATGTAGACATTTTAG
TGATTTCGAAACTGGCATGCACCA -> GATTTCGAAACTGGCATGCACCAG
GTGCGATGTAGACATTTTAGACTA -> TGCGATGTAGACATTTTAGACTAT
TGCCATAATTTACAATTATTTACT -> GCCATAATTTACAATTATTTACTT
CCGTTCTCCCGAGTGTGTTAGACC -> CGTTCTCCCGAGTGTGTTAGACCG
GATCCTGCCCAGATTGGGGCGCTC -> ATCCTGCCCAGATTGGGGCGCTCC
TAAGATCTGAGTACCTATTCATCC -> AAGATCTGAGTACCTATTCATCCG
TCCCTATAGCCCTGACACTCTTAG -> CCCTATAGCCCTGACACTCTTAGT
TGGCTTGATAATGGAATATACGAG -> GGCTTGATAATGGAATATACGAGA
AGCGACTATAGTTCCCTCGCTCGC -> GCGACTATAGTTCCCTCGCTCGCC
GTTGACAATTACTCGGGTTGCGAA -> TTGACAATTACTCGGGTTGCGAAT
TACCCGAGAGGATAATTCGATGTT -> ACCCGAGAGGATAATTCGATGTTA
TATAAAGATACTTGTGTTGACAAT -> ATAAAGATACTTGTGTTGACAATT
ACTAGACCGCTAATCGCGCGAACT -> CTAGACCGCTAATCGCGCGAACTT
TACCTCATCGGGGTGACGCACTAA -> ACCTCATCGGGGTGACGCACTAAT
TAGATCATCAGGTATAGCTCGTTG -> AGATCATCAGGTATAGCTCGTTGA
TGAACATACGCCCCTCCCTTGCGG -> GAACATACGCCCCTCCCTTGCGGG
ATTCCCTAGACTACGTCGACTGTA -> TTCCCTAGACTACGTCGACTGTAG
TAGCAGCATGTGTGGAAGTGAACG -> AGCAGCATGTGTGGAAGTGAACGT
AATCTGCAGTGTCGCCAGACCAAG -> ATCTGCAGTGTCGCCAGACCAAGA
TAGACATTTTAGACTATGCTTTAG -> AGACATTTTAGACTATGCTTTAGG
AGCTTTACCCGTAGTTAAAAATGT -> GCTTTACCCGTAGTTAAAAATGTG
TATCTACGTGGGACCGACAAGTGG -> ATCTACGTGGGACCGACAAGTGGC
ACCTATTCATCCGTTGCCAAGCTT -> CCTATTCATCCGTTGCCAAGCTTG
GCCCAGATATAGTGGTCCATGCTA -> CCCAGATATAGTGGTCCATGCTAG
GCGAGTTATCAGGTCCATGCAGAA -> CGAGTTATCAGGTCCATGCAGAAT
AGCCTGGACACTGAACCTGGCTGT -> GCCTGGACACTGAACCTGGCTGTG
TCGAGAGACCAAACCCCCACCCGG -> CGAGAGACCAAACCCCCACCCGGC
CAGTTGTTTAGATATAGAAACTCA -> AGTTGTTTAGATATAGAAACTCAG
AAGCTACATTGTGTGGTGATGCCC -> AGCTACATTGTGTGGTGATGCCCC
CTGGCATGCACCAGGATACGCTTA -> TGGCATGCACCAGGATACGCTTAG
CATAGCCTGTCCGGCAGCCTTCCT -> ATAGCCTGTCCGGCAGCCTTCCTA
GAAGACGGGCGTGTAGCCCGACTG -> AAGACGGGCGTGTAGCCCGACTGA
ACGAACAGAGTAATCGTTTTGGAT -> CGAACAGAGTAATCGTTTTGGATA
GCGGAGCTGGGAACGACGCCTAAG -> CGGAGCTGGGAACGACGCCTAAGA
CCTTTGTATCAAAAAATAGATGGG -> CTTTGTATCAAAAAATAGATGGGG
TTGTGCCTTTAGGCTGTTGACAAC -> TGTGCCTTTAGGCTGTTGACAACC
AGGACCAGTACGTATCTCTACTCG -> GGACCAGTACGTATCTCTACTCGT
TTTAGGCTGTTGACAACCTGAAGA -> TTAGGCTGTTGACAACCTGAAGAC
GGACCAGTACGTATCTCTACTCGT -> GACCAGTACGTATCTCTACTCGTG
ACATGATACCTTCGTGGTCCGAGC -> CATGATACCTTCGTGGTCCGAGCC
GCGCTGTACACCCTTCTAATTGCG -> CGCTGTACACCCTTCTAATTGCGG
ACGTGGGACCGACAAGTGGCTTGA -> CGTGGGACCGACAAGTGGCTTGAT
TCGGGTTGCGAATCTGAACAATGG -> CGGGTTGCGAATCTGAACAATGGC
TATCAAAAAATAGATGGGGCCTAG -> ATCAAAAAATAGATGGGGCCTAGT
AAAGGGCTACCTGGCAACAGAGGC -> AAGGGCTACCTGGCAACAGAGGCG
ACTTGATATCTACGTGGGACCGAC -> CTTGATATCTACGTGGGACCGACA
GATATAGTGGTCCATGCTAGAGAG -> ATATAGTGGTCCATGCTAGAGAGT
GTGTGGAAGTGAACGTTGTTATGA -> TGTGGAAGTGAACGTTGTTATGAA
AAGTCCTCAGCCTGGACACTGAAC -> AGTCCTCAGCCTGGACACTGAACC
TGTTTATAAAGGGCTACCTGGCAA -> GTTTATAAAGGGCTACCTGGCAAC
TGTCTCCCCGATATAGAGCATTCT -> GTCTCCCCGATATAGAGCATTCTC
ACGTTTGCTAGAAGCGTGCAGCGG -> CGTTTGCTAGAAGCGTGCAGCGGA
ATGCCAGTCGGACGGGAGTTGGCG -> TGCCAGTCGGACGGGAGTTGGCGG
GACTAGATCATTAATATCCTCTTT -> ACTAGATCATTAATATCCTCTTTA
GGTATAGCTCGTTGAACTGTCACG -> GTATAGCTCGTTGAACTGTCACGT
TGCCTAGCAGCATGTGTGGAAGTG -> GCCTAGCAGCATGTGTGGAAGTGA
CCAAGCTTGATTTCGAAACTGGCA -> CAAGCTTGATTTCGAAACTGGCAT
CTGTTGACAACCTGAAGACGGGCG -> TGTTGACAACCTGAAGACGGGCGT
CGTCCTCGAGAGACCAAACCCCCA -> GTCCTCGAGAGACCAAACCCCCAC
GCAGTGCCCCCCAATAGGCTACTA -> CAGTGCCCCCCAATAGGCTACTAT
CCCGATATAGAGCATTCTCGTTAC -> CCGATATAGAGCATTCTCGTTACG
TCATTAATATCCTCTTTACGTCAC -> CATTAATATCCTCTTTACGTCACA
TCCTTTGTATCAAAAAATAGATGG -> CCTTTGTATCAAAAAATAGATGGG
GTGTTAGTGGAAGGGGTGTCTCCC -> TGTTAGTGGAAGGGGTGTCTCCCC
ACTGGGCGAGCTGCGAGGCGCTGT -> CTGGGCGAGCTGCGAGGCGCTGTA
TCTTAGTGCCGGGTTCTTCGGTTG -> CTTAGTGCCGGGTTCTTCGGTTGG
TCTACGTGGGACCGACAAGTGGCT -> CTACGTGGGACCGACAAGTGGCTT
GGTGCCACGTGAAACGGTTCTCTG -> GTGCCACGTGAAACGGTTCTCTGA
GGCGAGCTGCGAGGCGCTGTACAC -> GCGAGCTGCGAGGCGCTGTACACC
GCAATCGACGAGCGATCTACAAAG -> CAATCGACGAGCGATCTACAAAGT
GCCGCTTACCCTTTCGCATGCGAG -> CCGCTTACCCTTTCGCATGCGAGT
TGTCACGTAATTTCCAGCCGAATC -> GTCACGTAATTTCCAGCCGAATCT
TTGTAGCCGCTTACCCTTTCGCAT -> TGTAGCCGCTTACCCTTTCGCATG
ATATTGCCATAATTTACAATTATT -> TATTGCCATAATTTACAATTATTT
TACGAGACACAAGAGGCAATCGAC -> ACGAGACACAAGAGGCAATCGACG
CGCCCCTCCCTTGCGGGATGTCAC -> GCCCCTCCCTTGCGGGATGTCACA
ACAATGGCAAGCTACATTGTGTGG -> CAATGGCAAGCTACATTGTGTGGT
ATACTCTTGTAGCCGCTTACCCTT -> TACTCTTGTAGCCGCTTACCCTTT
GTCACATGACCGTTGCCTAGCAGC -> TCACATGACCGTTGCCTAGCAGCA
AGAGGTAAAACGCCGGCGTTATTA -> GAGGTAAAACGCCGGCGTTATTAG
GGCAGTGTGGCTAATCGCTCCCTG -> GCAGTGTGGCTAATCGCTCCCTGA
ACCCGTAGTTAAAAATGTGGCCCC -> CCCGTAGTTAAAAATGTGGCCCCT
TGGGAACGACGCCTAAGACAACGG -> GGGAACGACGCCTAAGACAACGGC
TGGGGCCTAGTGGTCTAAGAGTCG -> GGGGCCTAGTGGTCTAAGAGTCGC
GCACTATCGGGCACCAGCAGTTGT -> CACTATCGGGCACCAGCAGTTGTC
CCAATAGGCTACTATGTGACTTTC -> CAATAGGCTACTATGTGACTTTCG
TTGCGGGATGTCACACGTGGATAC -> TGCGGGATGTCACACGTGGATACC
GACAATTACTCGGGTTGCGAATCT -> ACAATTACTCGGGTTGCGAATCTG
TGCGAGTTATCAGGTCCATGCAGA -> GCGAGTTATCAGGTCCATGCAGAA
CGTTGAACTGTCACGTAATTTCCA -> GTTGAACTGTCACGTAATTTCCAG
GTATAGCTCGTTGAACTGTCACGT -> TATAGCTCGTTGAACTGTCACGTA
TTGGATATCTGTGGGTAGCAGCCA -> TGGATATCTGTGGGTAGCAGCCAG
CTTTACGTCACATGACCGTTGCCT -> TTTACGTCACATGACCGTTGCCTA
AGGTAACCATTATGTGTGATCACT -> GGTAACCATTATGTGTGATCACTG
TAATTAATAGTACCCGAGAGGATA -> AATTAATAGTACCCGAGAGGATAA
GGGTTCTTCGGTTGGCCTTTCGCA -> GGTTCTTCGGTTGGCCTTTCGCAT
ACTATGTGACTTTCGGGTCTTTAT -> CTATGTGACTTTCGGGTCTTTATC
GCCATAGAGTTTAAGATCTGAGTA -> CCATAGAGTTTAAGATCTGAGTAC
CCTTGGATGCCAGTCGGACGGGAG -> CTTGGATGCCAGTCGGACGGGAGT
AGCGGGCTCCATTGCACCGCGACA -> GCGGGCTCCATTGCACCGCGACAA
GCGACAATCTGCAGTGTCGCCAGA -> CGACAATCTGCAGTGTCGCCAGAC
CTCGTGACTAAGTCCTCAGCCTGG -> TCGTGACTAAGTCCTCAGCCTGGA
AGCCATAGAGTTTAAGATCTGAGT -> GCCATAGAGTTTAAGATCTGAGTA
CTGTTTATAAAGGGCTACCTGGCA -> TGTTTATAAAGGGCTACCTGGCAA
GATACCTAGGCTGAACGGCCCAGA -> ATACCTAGGCTGAACGGCCCAGAT
CTAATATGAGACTAACAGTTGTTT -> TAATATGAGACTAACAGTTGTTTA
CCCTTGGCTTATCGGCCCTCGGAA -> CCTTGGCTTATCGGCCCTCGGAAA
TTGTGTTGACAATTACTCGGGTTG -> TGTGTTGACAATTACTCGGGTTGC
CCCAATCTTGTGCTTAAATCATGA -> CCAATCTTGTGCTTAAATCATGAA
AGCTACATTGTGTGGTGATGCCCC -> GCTACATTGTGTGGTGATGCCCCT
GTTGCCAAGCTTGATTTCGAAACT -> TTGCCAAGCTTGATTTCGAAACTG
ACCGTTGCCTAGCAGCATGTGTGG -> CCGTTGCCTAGCAGCATGTGTGGA
TTAGATCATCAGGTATAGCTCGTT -> TAGATCATCAGGTATAGCTCGTTG
AATTCGATGTTATGTTAGCGAATT -> ATTCGATGTTATGTTAGCGAATTG
TCGCATTGAATGTATTACGTTTGC -> CGCATTGAATGTATTACGTTTGCT
AGGCGACGAGAAAATACTCTTGTA -> GGCGACGAGAAAATACTCTTGTAG
AATATGAGACTAACAGTTGTTTAG -> ATATGAGACTAACAGTTGTTTAGA
ATGTATTACGTTTGCTAGAAGCGT -> TGTATTACGTTTGCTAGAAGCGTG
GGGGTGTCTCCCCGATATAGAGCA -> GGGTGTCTCCCCGATATAGAGCAT
CAGCAGTTGTCTGTTTATAAAGGG -> AGCAGTTGTCTGTTTATAAAGGGC
GACGGGCAGTGTGGCTAATCGCTC -> ACGGGCAGTGTGGCTAATCGCTCC
TCTTGTGCTTAAATCATGAACATA -> CTTGTGCTTAAATCATGAACATAC
CCTGCCCAGATTGGGGCGCTCCCC -> CTGCCCAGATTGGGGCGCTCCCCC
TACGTCACATGACCGTTGCCTAGC -> ACGTCACATGACCGTTGCCTAGCA
AGTTGTCTGTTTATAAAGGGCTAC -> GTTGTCTGTTTATAAAGGGCTACC
GAGACCAAACCCCCACCCGGCTGA -> AGACCAAACCCCCACCCGGCTGAT
TTGTGTGGTGATGCCCCTTCCACT -> TGTGTGGTGATGCCCCTTCCACTT
CTTTCGCATGCGAGTTATCAGGTC -> TTTCGCATGCGAGTTATCAGGTCC
GGGCACCAGCAGTTGTCTGTTTAT -> GGCACCAGCAGTTGTCTGTTTATA
AACAGTTGTTTAGATATAGAAACT -> ACAGTTGTTTAGATATAGAAACTC
TGTTCTTAAGACGCTAATTAATAG -> GTTCTTAAGACGCTAATTAATAGT
CTAGAGAGTCAGTACATTTCAGCG -> TAGAGAGTCAGTACATTTCAGCGT
CCTAATGCCTATGCTAGGCACGCA -> CTAATGCCTATGCTAGGCACGCAC
ACCAGGATACGCTTAGAGGTAAAA -> CCAGGATACGCTTAGAGGTAAAAC
CTGAGGGATGCGGACATGATACCT -> TGAGGGATGCGGACATGATACCTT
AATAGATGGGGCCTAGTGGTCTAA -> ATAGATGGGGCCTAGTGGTCTAAG
ATTGTGTGGTGATGCCCCTTCCAC -> TTGTGTGGTGATGCCCCTTCCACT
TAGTTAAAAATGTGGCCCCTGTGA -> AGTTAAAAATGTGGCCCCTGTGAC
GTCAGTCGGTAACACATACTCGCT -> TCAGTCGGTAACACATACTCGCTT
CCTGACACTCTTAGTGCCGGGTTC -> CTGACACTCTTAGTGCCGGGTTCT
CTAGACTAGATCATTAATATCCTC -> TAGACTAGATCATTAATATCCTCT
CCCGAGAGGATAATTCGATGTTAT -> CCGAGAGGATAATTCGATGTTATG
CCCTGATCCGACTCGTGACTAAGT -> CCTGATCCGACTCGTGACTAAGTC
CTTTCGGGTCTTTATCCTAATGCC -> TTTCGGGTCTTTATCCTAATGCCT
AGAGGCAATCGACGAGCGATCTAC -> GAGGCAATCGACGAGCGATCTACA
ATTTACAATTATTTACTTGATATC -> TTTACAATTATTTACTTGATATCT
ATAAAAATCCTTTGTATCAAAAAA -> TAAAAATCCTTTGTATCAAAAAAT
GGACGGGAGTTGGCGGATTCCCTA -> GACGGGAGTTGGCGGATTCCCTAG
TATAGAGCATTCTCGTTACGAACA -> ATAGAGCATTCTCGTTACGAACAG
CTCGCGGTCTATGCTCTTGCTTTT -> TCGCGGTCTATGCTCTTGCTTTTA
GACAATCTGCAGTGTCGCCAGACC -> ACAATCTGCAGTGTCGCCAGACCA
TCAGCCTGGACACTGAACCTGGCT -> CAGCCTGGACACTGAACCTGGCTG
TCCTCGAGAGACCAAACCCCCACC -> CCTCGAGAGACCAAACCCCCACCC
CTTGGATGCCAGTCGGACGGGAGT -> TTGGATGCCAGTCGGACGGGAGTT
GAACTGTCACGTAATTTCCAGCCG -> AACTGTCACGTAATTTCCAGCCGA
ACTAACAGTTGTTTAGATATAGAA -> CTAACAGTTGTTTAGATATAGAAA
GGGTTGCCGAGTCAGTCGGTAACA -> GGTTGCCGAGTCAGTCGGTAACAC
CGTTATTAGCAGGGTCTCCTATAG -> GTTATTAGCAGGGTCTCCTATAGC
CCTTTAGGCTGTTGACAACCTGAA -> CTTTAGGCTGTTGACAACCTGAAG
TTTACGCGGACTCCTATAATAAAA -> TTACGCGGACTCCTATAATAAAAA
GCCTAGCAGCATGTGTGGAAGTGA -> CCTAGCAGCATGTGTGGAAGTGAA
GCCTATGCTAGGCACGCACTAGAC -> CCTATGCTAGGCACGCACTAGACC
GCGCAACTATTGATTAGATCATCA -> CGCAACTATTGATTAGATCATCAG
CCGCACCATTTGCAAGAACAATGT -> CGCACCATTTGCAAGAACAATGTG
CCATGCAGAATCCATACGCGATAC -> CATGCAGAATCCATACGCGATACC
CTAAGAGTCGCGAGGAATACCTCA -> TAAGAGTCGCGAGGAATACCTCAT
CGACGCTCACACGCATAGCCTGTC -> GACGCTCACACGCATAGCCTGTCC
CAGGTCCATGCAGAATCCATACGC -> AGGTCCATGCAGAATCCATACGCG
TGTGCGATGTAGACATTTTAGACT -> GTGCGATGTAGACATTTTAGACTA
TATCCTAATGCCTATGCTAGGCAC -> ATCCTAATGCCTATGCTAGGCACG
GTCAGTACATTTCAGCGTCAGTAT -> TCAGTACATTTCAGCGTCAGTATC
CATGCTAGAGAGTCAGTACATTTC -> ATGCTAGAGAGTCAGTACATTTCA
TAAGACGCTAATTAATAGTACCCG -> AAGACGCTAATTAATAGTACCCGA
GATCACTACCAAGGTGCCACGTGA -> ATCACTACCAAGGTGCCACGTGAA
ATTCGATGTTATGTTAGCGAATTG -> TTCGATGTTATGTTAGCGAATTGT
GGGGCCTAGTGGTCTAAGAGTCGC -> GGGCCTAGTGGTCTAAGAGTCGCG
AATTAGCCGGAAAAGGCGACGAGA -> ATTAGCCGGAAAAGGCGACGAGAA
GACGCGAGCGACTATAGTTCCCTC -> ACGCGAGCGACTATAGTTCCCTCG
ACAGGGCCGATTTATCCCAATCTT -> CAGGGCCGATTTATCCCAATCTTG
GGGCTACCAGAGCAGTGCCCCCCA -> GGCTACCAGAGCAGTGCCCCCCAA
GCACGCACTAGACCGCTAATCGCG -> CACGCACTAGACCGCTAATCGCGC
TTGTCTGTTTATAAAGGGCTACCT -> TGTCTGTTTATAAAGGGCTACCTG
GTCGACTGTAGACGGGCAGTGTGG -> TCGACTGTAGACGGGCAGTGTGGC
CCTTCCACTTAATCGTCCCTATAG -> CTTCCACTTAATCGTCCCTATAGC
AATCATGAACATACGCCCCTCCCT -> ATCATGAACATACGCCCCTCCCTT
CGTACGCAGGGGTTGCCGAGTCAG -> GTACGCAGGGGTTGCCGAGTCAGT
ACCCGGCTGATTCTGCATATTGCC -> CCCGGCTGATTCTGCATATTGCCA
AGTGGTCCATGCTAGAGAGTCAGT -> GTGGTCCATGCTAGAGAGTCAGTA
TAACTGGGCGAGCTGCGAGGCGCT -> AACTGGGCGAGCTGCGAGGCGCTG
GAACGTCCTCGAGAGACCAAACCC -> AACGTCCTCGAGAGACCAAACCCC
TGGGTAGCAGCCAGAAGGGCTAAT -> GGGTAGCAGCCAGAAGGGCTAATT
TGTGGAAGTGAACGTTGTTATGAA -> GTGGAAGTGAACGTTGTTATGAAT
AGGGCTAATTAGCCGGAAAAGGCG -> GGGCTAATTAGCCGGAAAAGGCGA
GAACAATGGCAAGCTACATTGTGT -> AACAATGGCAAGCTACATTGTGTG
GATCATCAGGTATAGCTCGTTGAA -> ATCATCAGGTATAGCTCGTTGAAC
CATAGAGTTTAAGATCTGAGTACC -> ATAGAGTTTAAGATCTGAGTACCT
ATAGTGGTCCATGCTAGAGAGTCA -> TAGTGGTCCATGCTAGAGAGTCAG
AGCCTGTCCGGCAGCCTTCCTAAT -> GCCTGTCCGGCAGCCTTCCTAATT
TGAACGTTGTTATGAATCGACGCT -> GAACGTTGTTATGAATCGACGCTC
TACGCAGGGGTTGCCGAGTCAGTC -> ACGCAGGGGTTGCCGAGTCAGTCG
TCGTTGAACTGTCACGTAATTTCC -> CGTTGAACTGTCACGTAATTTCCA
CACCATTTGCAAGAACAATGTGTT -> ACCATTTGCAAGAACAATGTGTTA
ATCTGAACAATGGCAAGCTACATT -> TCTGAACAATGGCAAGCTACATTG
GGCTGTGCGATGTAGACATTTTAG -> GCTGTGCGATGTAGACATTTTAGA
GGATATCTGTGGGTAGCAGCCAGA -> GATATCTGTGGGTAGCAGCCAGAA
TTAGACTATGCTTTAGGTCCGAGC -> TAGACTATGCTTTAGGTCCGAGCT
CGAGTTATCAGGTCCATGCAGAAT -> GAGTTATCAGGTCCATGCAGAATC
TTCCTTGGATGCCAGTCGGACGGG -> TCCTTGGATGCCAGTCGGACGGGA
ATCTTGTGCTTAAATCATGAACAT -> TCTTGTGCTTAAATCATGAACATA
ATAGACCGCACCATTTGCAAGAAC -> TAGACCGCACCATTTGCAAGAACA
ACCGACAAGTGGCTTGATAATGGA -> CCGACAAGTGGCTTGATAATGGAA
CGACTATAGTTCCCTCGCTCGCCC -> GACTATAGTTCCCTCGCTCGCCCG
TGCTAGGCACGCACTAGACCGCTA -> GCTAGGCACGCACTAGACCGCTAA
GGACCGACAAGTGGCTTGATAATG -> GACCGACAAGTGGCTTGATAATGG
TACCAAGGTGCCACGTGAAACGGT -> ACCAAGGTGCCACGTGAAACGGTT
ATACCTAGGCTGAACGGCCCAGAT -> TACCTAGGCTGAACGGCCCAGATA
GTTACGAACAGAGTAATCGTTTTG -> TTACGAACAGAGTAATCGTTTTGG
GTGGGGCTACCAGAGCAGTGCCCC -> TGGGGCTACCAGAGCAGTGCCCCC
GAGAGCGTCATAGACCGCACCATT -> AGAGCGTCATAGACCGCACCATTT
CACATGGCGGTCAACGTACGCAGG -> ACATGGCGGTCAACGTACGCAGGG
AGTGAGAGAGCGTCATAGACCGCA -> GTGAGAGAGCGTCATAGACCGCAC
TTACCCTTTCGCATGCGAGTTATC -> TACCCTTTCGCATGCGAGTTATCA
GAGTTTAAGATCTGAGTACCTATT -> AGTTTAAGATCTGAGTACCTATTC
AGTGCTAGGAACGTCCTCGAGAGA -> GTGCTAGGAACGTCCTCGAGAGAC
ATACGCTTAGAGGTAAAACGCCGG -> TACGCTTAGAGGTAAAACGCCGGC
AGACCGGTTCCGGAAACTAGACTA -> GACCGGTTCCGGAAACTAGACTAG
TGCATAGGACCAGTACGTATCTCT -> GCATAGGACCAGTACGTATCTCTA
CCCTTGCGGGATGTCACACGTGGA -> CCTTGCGGGATGTCACACGTGGAT
GACTGAACAGGGCCGATTTATCCC -> ACTGAACAGGGCCGATTTATCCCA
CCATACGCGATACCTAGGCTGAAC -> CATACGCGATACCTAGGCTGAACG
TGAATCGACGCTCACACGCATAGC -> GAATCGACGCTCACACGCATAGCC
GCAGAATCCATACGCGATACCTAG -> CAGAATCCATACGCGATACCTAGG
CGCTAATCGCGCGAACTTCGTAGG -> GCTAATCGCGCGAACTTCGTAGGT
GTCACACGTGGATACCTGCTCCCT -> TCACACGTGGATACCTGCTCCCTT
CTACTATGTGACTTTCGGGTCTTT -> TACTATGTGACTTTCGGGTCTTTA
CGACTCGTGACTAAGTCCTCAGCC -> GACTCGTGACTAAGTCCTCAGCCT
TCGACGAGCGATCTACAAAGTTAA -> CGACGAGCGATCTACAAAGTTAAC
TCGGAAAACCGCAATTGGTCCGTG -> CGGAAAACCGCAATTGGTCCGTGG
ATCGGGGTGACGCACTAATATGAG -> TCGGGGTGACGCACTAATATGAGA
TGGTCTAAGAGTCGCGAGGAATAC -> GGTCTAAGAGTCGCGAGGAATACC
TATCTCTACTCGTGAAGGTCAGAA -> ATCTCTACTCGTGAAGGTCAGAAG
ACGTAATTTCCAGCCGAATCTCCG -> CGTAATTTCCAGCCGAATCTCCGT
TGCCCCTTCCACTTAATCGTCCCT -> GCCCCTTCCACTTAATCGTCCCTA
CGCGAACTTCGTAGGTAACCATTA -> GCGAACTTCGTAGGTAACCATTAT
ACTATGCTTTAGGTCCGAGCTTTA -> CTATGCTTTAGGTCCGAGCTTTAC
TCCATGCAGAATCCATACGCGATA -> CCATGCAGAATCCATACGCGATAC
CGCAGGGGTTGCCGAGTCAGTCGG -> GCAGGGGTTGCCGAGTCAGTCGGT
GAGTACCTATTCATCCGTTGCCAA -> AGTACCTATTCATCCGTTGCCAAG
GTTGGCCTTTCGCATTGAATGTAT -> TTGGCCTTTCGCATTGAATGTATT
ACAATGTGTTAGTGGAAGGGGTGT -> CAATGTGTTAGTGGAAGGGGTGTC
GACGCTCACACGCATAGCCTGTCC -> ACGCTCACACGCATAGCCTGTCCG
ACCAAGGTGCCACGTGAAACGGTT -> CCAAGGTGCCACGTGAAACGGTTC
ACAGAGGCGAACCCCGTTCTCCCG -> CAGAGGCGAACCCCGTTCTCCCGA
CCCCTGTGACGATCCTGCCCAGAT -> CCCTGTGACGATCCTGCCCAGATT
GTGGAAGTGAACGTTGTTATGAAT -> TGGAAGTGAACGTTGTTATGAATC
AGGTCCGAGCTTTACCCGTAGTTA -> GGTCCGAGCTTTACCCGTAGTTAA
TATAATAAAAATCCTTTGTATCAA -> ATAATAAAAATCCTTTGTATCAAA
TACTCGCTTTCAGTGCTAGGAACG -> ACTCGCTTTCAGTGCTAGGAACGT
ACTAATATGAGACTAACAGTTGTT -> CTAATATGAGACTAACAGTTGTTT
ACTGTAGACGGGCAGTGTGGCTAA -> CTGTAGACGGGCAGTGTGGCTAAT
GTTATGTTAGCGAATTGTGCCTTT -> TTATGTTAGCGAATTGTGCCTTTA
CTCGTTGAACTGTCACGTAATTTC -> TCGTTGAACTGTCACGTAATTTCC
ATTAATATCCTCTTTACGTCACAT -> TTAATATCCTCTTTACGTCACATG
GCCCCTCTTGAGCGGGCTCCATTG -> CCCCTCTTGAGCGGGCTCCATTGC
GTGTCTCCCCGATATAGAGCATTC -> TGTCTCCCCGATATAGAGCATTCT
TCGCCCGAGAGTCACTATGGGATG -> CGCCCGAGAGTCACTATGGGATGT
CTTTCGCATTGAATGTATTACGTT -> TTTCGCATTGAATGTATTACGTTT
TGCCGAGTCAGTCGGTAACACATA -> GCCGAGTCAGTCGGTAACACATAC
GGACGACGCGAGCGACTATAGTTC -> GACGACGCGAGCGACTATAGTTCC
TAGAAACTCAGCACCAGGTCTTGG -> AGAAACTCAGCACCAGGTCTTGGT
AAAACCGCAATTGGTCCGTGGTTG -> AAACCGCAATTGGTCCGTGGTTGC
CCCAATAGGCTACTATGTGACTTT -> CCAATAGGCTACTATGTGACTTTC
AGTTTAAGATCTGAGTACCTATTC -> GTTTAAGATCTGAGTACCTATTCA
AATCGACGCTCACACGCATAGCCT -> ATCGACGCTCACACGCATAGCCTG
CCCAGATTGGGGCGCTCCCCCTTG -> CCAGATTGGGGCGCTCCCCCTTGA
GTTTGCTAGAAGCGTGCAGCGGAG -> TTTGCTAGAAGCGTGCAGCGGAGC
CCGGAAACTAGACTAGATCATTAA -> CGGAAACTAGACTAGATCATTAAT
GAGAGAGCGTCATAGACCGCACCA -> AGAGAGCGTCATAGACCGCACCAT
AACCGCAATTGGTCCGTGGTTGCA -> ACCGCAATTGGTCCGTGGTTGCAA
ACTTTCGGGTCTTTATCCTAATGC -> CTTTCGGGTCTTTATCCTAATGCC
ATCCTGCCCAGATTGGGGCGCTCC -> TCCTGCCCAGATTGGGGCGCTCCC
CTAACAGTTGTTTAGATATAGAAA -> TAACAGTTGTTTAGATATAGAAAC
TGGACGACGCGAGCGACTATAGTT -> GGACGACGCGAGCGACTATAGTTC
TCCTGCCCAGATTGGGGCGCTCCC -> CCTGCCCAGATTGGGGCGCTCCCC
GCAGCATGTGTGGAAGTGAACGTT -> CAGCATGTGTGGAAGTGAACGTTG
GAGAGTCAGTACATTTCAGCGTCA -> AGAGTCAGTACATTTCAGCGTCAG
GAACCCCGTTCTCCCGAGTGTGTT -> AACCCCGTTCTCCCGAGTGTGTTA
TCTCCCCGATATAGAGCATTCTCG -> CTCCCCGATATAGAGCATTCTCGT
TGCATATTGCCATAATTTACAATT -> GCATATTGCCATAATTTACAATTA
ATGCACCAGGATACGCTTAGAGGT -> TGCACCAGGATACGCTTAGAGGTA
ATTGCACCGCGACAATCTGCAGTG -> TTGCACCGCGACAATCTGCAGTGT
CCTGGCAACAGAGGCGAACCCCGT -> CTGGCAACAGAGGCGAACCCCGTT
GCTACCAGAGCAGTGCCCCCCAAT -> CTACCAGAGCAGTGCCCCCCAATA
TGAACAGGGCCGATTTATCCCAAT -> GAACAGGGCCGATTTATCCCAATC
GGATACCTGCTCCCTTGGCTTATC -> GATACCTGCTCCCTTGGCTTATCG
TATGGGATGTATCGATACCACATG -> ATGGGATGTATCGATACCACATGG
GTCTCCTATAGCGCCCTGTCGGTC -> TCTCCTATAGCGCCCTGTCGGTCT
CGACGCGAGCGACTATAGTTCCCT -> GACGCGAGCGACTATAGTTCCCTC
ACGCGGACTCCTATAATAAAAATC -> CGCGGACTCCTATAATAAAAATCC
TGTGATCACTGCCTCGCGGTCTAT -> GTGATCACTGCCTCGCGGTCTATG
ACGTCCTCGAGAGACCAAACCCCC -> CGTCCTCGAGAGACCAAACCCCCA
GTGCCTTTAGGCTGTTGACAACCT -> TGCCTTTAGGCTGTTGACAACCTG
TGGCCCCTGTGACGATCCTGCCCA -> GGCCCCTGTGACGATCCTGCCCAG
ACTAGATCATTAATATCCTCTTTA -> CTAGATCATTAATATCCTCTTTAC
TCCTTGGATGCCAGTCGGACGGGA -> CCTTGGATGCCAGTCGGACGGGAG
GCGAACCCCGTTCTCCCGAGTGTG -> CGAACCCCGTTCTCCCGAGTGTGT
TTGGATGCCAGTCGGACGGGAGTT -> TGGATGCCAGTCGGACGGGAGTTG
GCATGCGAGTTATCAGGTCCATGC -> CATGCGAGTTATCAGGTCCATGCA
GAGTAATCGTTTTGGATATCTGTG -> AGTAATCGTTTTGGATATCTGTGG
CCGCTAATCGCGCGAACTTCGTAG -> CGCTAATCGCGCGAACTTCGTAGG
CAGATATAGTGGTCCATGCTAGAG -> AGATATAGTGGTCCATGCTAGAGA
GGGTAGCAGCCAGAAGGGCTAATT -> GGTAGCAGCCAGAAGGGCTAATTA
GCTGCGAGGCGCTGTACACCCTTC -> CTGCGAGGCGCTGTACACCCTTCT
AACTGTCACGTAATTTCCAGCCGA -> ACTGTCACGTAATTTCCAGCCGAA
ATGTATCGATACCACATGGCGGTC -> TGTATCGATACCACATGGCGGTCA
TCCATTGCACCGCGACAATCTGCA -> CCATTGCACCGCGACAATCTGCAG
CGTGGGACCGACAAGTGGCTTGAT -> GTGGGACCGACAAGTGGCTTGATA
TCAGTATCCTATAAAGATACTTGT -> CAGTATCCTATAAAGATACTTGTG
GACATGATACCTTCGTGGTCCGAG -> ACATGATACCTTCGTGGTCCGAGC
TGCCGGGTTCTTCGGTTGGCCTTT -> GCCGGGTTCTTCGGTTGGCCTTTC
GTCATAGACCGCACCATTTGCAAG -> TCATAGACCGCACCATTTGCAAGA
AGCGTGCAGCGGAGCTGGGAACGA -> GCGTGCAGCGGAGCTGGGAACGAC
AGACATTTTAGACTATGCTTTAGG -> GACATTTTAGACTATGCTTTAGGT
CAGTGCTAGGAACGTCCTCGAGAG -> AGTGCTAGGAACGTCCTCGAGAGA
ATCATGAACATACGCCCCTCCCTT -> TCATGAACATACGCCCCTCCCTTG
AGGTGCGACTTGTTCTTAAGACGC -> GGTGCGACTTGTTCTTAAGACGCT
TTCGTGGTCCGAGCCTTGAGGTGC -> TCGTGGTCCGAGCCTTGAGGTGCG
CGAGACACAAGAGGCAATCGACGA -> GAGACACAAGAGGCAATCGACGAG
AATCTTGTGCTTAAATCATGAACA -> ATCTTGTGCTTAAATCATGAACAT
CCATAATTTACAATTATTTACTTG -> CATAATTTACAATTATTTACTTGA
TCAACGTACGCAGGGGTTGCCGAG -> CAACGTACGCAGGGGTTGCCGAGT
CTGGCAACAGAGGCGAACCCCGTT -> TGGCAACAGAGGCGAACCCCGTTC
CCCGAGTGTGTTAGACCGGTTCCG -> CCGAGTGTGTTAGACCGGTTCCGG
AACTCAGCACCAGGTCTTGGTGTG -> ACTCAGCACCAGGTCTTGGTGTGC
CGGTCTAGAGATCACTACCAAGGT -> GGTCTAGAGATCACTACCAAGGTG
ACCTGCTCCCTTGGCTTATCGGCC -> CCTGCTCCCTTGGCTTATCGGCCC
GCGGTCTATGCTCTTGCTTTTACG -> CGGTCTATGCTCTTGCTTTTACGC
CTCCCTTGGCTTATCGGCCCTCGG -> TCCCTTGGCTTATCGGCCCTCGGA
CTAGAAGCGTGCAGCGGAGCTGGG -> TAGAAGCGTGCAGCGGAGCTGGGA
CGCTGTACACCCTTCTAATTGCGG -> GCTGTACACCCTTCTAATTGCGGT
TGCGGACATGATACCTTCGTGGTC -> GCGGACATGATACCTTCGTGGTCC
CACTGCCTCGCGGTCTATGCTCTT -> ACTGCCTCGCGGTCTATGCTCTTG
TCTAGAGATCACTACCAAGGTGCC -> CTAGAGATCACTACCAAGGTGCCA
TAAAGGGCTACCTGGCAACAGAGG -> AAAGGGCTACCTGGCAACAGAGGC
CTCTTTACGTCACATGACCGTTGC -> TCTTTACGTCACATGACCGTTGCC
CGCGCGAACTTCGTAGGTAACCAT -> GCGCGAACTTCGTAGGTAACCATT
GAGTGTGTTAGACCGGTTCCGGAA -> AGTGTGTTAGACCGGTTCCGGAAA
CCTAGGCTGAACGGCCCAGATATA -> CTAGGCTGAACGGCCCAGATATAG
AGAGAGCGTCATAGACCGCACCAT -> GAGAGCGTCATAGACCGCACCATT
CCACGTGAAACGGTTCTCTGAGGG -> CACGTGAAACGGTTCTCTGAGGGA
GGCCGATTTATCCCAATCTTGTGC -> GCCGATTTATCCCAATCTTGTGCT
AGGATAATTCGATGTTATGTTAGC -> GGATAATTCGATGTTATGTTAGCG
TGTTAGTGGAAGGGGTGTCTCCCC -> GTTAGTGGAAGGGGTGTCTCCCCG
CCTGTCCGGCAGCCTTCCTAATTT -> CTGTCCGGCAGCCTTCCTAATTTT
ACCCGAGAGGATAATTCGATGTTA -> CCCGAGAGGATAATTCGATGTTAT
TGTAGACATTTTAGACTATGCTTT -> GTAGACATTTTAGACTATGCTTTA
GCGATCTACAAAGTTAACTGGGCG -> CGATCTACAAAGTTAACTGGGCGA
GCCCGACTGAACAGGGCCGATTTA -> CCCGACTGAACAGGGCCGATTTAT
AACGTTGTTATGAATCGACGCTCA -> ACGTTGTTATGAATCGACGCTCAC
CTGGACACTGAACCTGGCTGTGCG -> TGGACACTGAACCTGGCTGTGCGA
CGGTTCTCTGAGGGATGCGGACAT -> GGTTCTCTGAGGGATGCGGACATG
GCCCTGTCGGTCTAGAGATCACTA -> CCCTGTCGGTCTAGAGATCACTAC
GTTGGCGGATTCCCTAGACTACGT -> TTGGCGGATTCCCTAGACTACGTC
CAACTATTGATTAGATCATCAGGT -> AACTATTGATTAGATCATCAGGTA
TCGCTTTCAGTGCTAGGAACGTCC -> CGCTTTCAGTGCTAGGAACGTCCT
ATCCTCTTTACGTCACATGACCGT -> TCCTCTTTACGTCACATGACCGTT
CGACGAGAAAATACTCTTGTAGCC -> GACGAGAAAATACTCTTGTAGCCG
ACCGCACCATTTGCAAGAACAATG -> CCGCACCATTTGCAAGAACAATGT
TTGGCGGATTCCCTAGACTACGTC -> TGGCGGATTCCCTAGACTACGTCG
TGAAGACGGGCGTGTAGCCCGACT -> GAAGACGGGCGTGTAGCCCGACTG
TGTGGCCCCTGTGACGATCCTGCC -> GTGGCCCCTGTGACGATCCTGCCC
GGAGTTGGCGGATTCCCTAGACTA -> GAGTTGGCGGATTCCCTAGACTAC
CAATCTGCAGTGTCGCCAGACCAA -> AATCTGCAGTGTCGCCAGACCAAG
TGTGCATAGGACCAGTACGTATCT -> GTGCATAGGACCAGTACGTATCTC
CTGATTCTGCATATTGCCATAATT -> TGATTCTGCATATTGCCATAATTT
GCCACGTGAAACGGTTCTCTGAGG -> CCACGTGAAACGGTTCTCTGAGGG
GAAAACCGCAATTGGTCCGTGGTT -> AAAACCGCAATTGGTCCGTGGTTG
AAGAACAATGTGTTAGTGGAAGGG -> AGAACAATGTGTTAGTGGAAGGGG
AAAAATCCTTTGTATCAAAAAATA -> AAAATCCTTTGTATCAAAAAATAG
AGCTTGATTTCGAAACTGGCATGC -> GCTTGATTTCGAAACTGGCATGCA
TACTCTTGTAGCCGCTTACCCTTT -> ACTCTTGTAGCCGCTTACCCTTTC
CCTAGTGGTCTAAGAGTCGCGAGG -> CTAGTGGTCTAAGAGTCGCGAGGA
AGCAGTGCCCCCCAATAGGCTACT -> GCAGTGCCCCCCAATAGGCTACTA
TGCGACTTGTTCTTAAGACGCTAA -> GCGACTTGTTCTTAAGACGCTAAT
GGTGGGGCTACCAGAGCAGTGCCC -> GTGGGGCTACCAGAGCAGTGCCCC
TTCGATGTTATGTTAGCGAATTGT -> TCGATGTTATGTTAGCGAATTGTG
AGGTCTTGGTGTGCATAGGACCAG -> GGTCTTGGTGTGCATAGGACCAGT
GTGCATAGGACCAGTACGTATCTC -> TGCATAGGACCAGTACGTATCTCT
TATTGCCATAATTTACAATTATTT -> ATTGCCATAATTTACAATTATTTA
GGCGTGTAGCCCGACTGAACAGGG -> GCGTGTAGCCCGACTGAACAGGGC
TCTCGTTACGAACAGAGTAATCGT -> CTCGTTACGAACAGAGTAATCGTT
ATATCTACGTGGGACCGACAAGTG -> TATCTACGTGGGACCGACAAGTGG
CTTGAGGTGCGACTTGTTCTTAAG -> TTGAGGTGCGACTTGTTCTTAAGA
TCTTGTAGCCGCTTACCCTTTCGC -> CTTGTAGCCGCTTACCCTTTCGCA
ATGAATCGACGCTCACACGCATAG -> TGAATCGACGCTCACACGCATAGC
TGGGACCGACAAGTGGCTTGATAA -> GGGACCGACAAGTGGCTTGATAAT
TCCTATAAAGATACTTGTGTTGAC -> CCTATAAAGATACTTGTGTTGACA
CGGCTGATTCTGCATATTGCCATA -> GGCTGATTCTGCATATTGCCATAA
TGTGTTAGTGGAAGGGGTGTCTCC -> GTGTTAGTGGAAGGGGTGTCTCCC
CCAGGTCTTGGTGTGCATAGGACC -> CAGGTCTTGGTGTGCATAGGACCA
AGGGCCGATTTATCCCAATCTTGT -> GGGCCGATTTATCCCAATCTTGTG
GGTTGCAACGCCCCTCTTGAGCGG -> GTTGCAACGCCCCTCTTGAGCGGG
AACGGTTCTCTGAGGGATGCGGAC -> ACGGTTCTCTGAGGGATGCGGACA
TTCAGTGCTAGGAACGTCCTCGAG -> TCAGTGCTAGGAACGTCCTCGAGA
AATAGTACCCGAGAGGATAATTCG -> ATAGTACCCGAGAGGATAATTCGA
CAGGATACGCTTAGAGGTAAAACG -> AGGATACGCTTAGAGGTAAAACGC
ACGGGCAGTGTGGCTAATCGCTCC -> CGGGCAGTGTGGCTAATCGCTCCC
TGTTTAGATATAGAAACTCAGCAC -> GTTTAGATATAGAAACTCAGCACC
CTGTAGACGGGCAGTGTGGCTAAT -> TGTAGACGGGCAGTGTGGCTAATC
ATCGGGCACCAGCAGTTGTCTGTT -> TCGGGCACCAGCAGTTGTCTGTTT
CTTTAGGCTGTTGACAACCTGAAG -> TTTAGGCTGTTGACAACCTGAAGA
GCACCAGGTCTTGGTGTGCATAGG -> CACCAGGTCTTGGTGTGCATAGGA
GACCAAACCCCCACCCGGCTGATT -> ACCAAACCCCCACCCGGCTGATTC
CTTGGTGTGCATAGGACCAGTACG -> TTGGTGTGCATAGGACCAGTACGT
TTTCGAAACTGGCATGCACCAGGA -> TTCGAAACTGGCATGCACCAGGAT
ATTATGTGTGATCACTGCCTCGCG -> TTATGTGTGATCACTGCCTCGCGG
TGCCCAGATTGGGGCGCTCCCCCT -> GCCCAGATTGGGGCGCTCCCCCTT
GTTCCCTCGCTCGCCCGAGAGTCA -> TTCCCTCGCTCGCCCGAGAGTCAC
CATGACCGTTGCCTAGCAGCATGT -> ATGACCGTTGCCTAGCAGCATGTG
TCGCATGCGAGTTATCAGGTCCAT -> CGCATGCGAGTTATCAGGTCCATG
GTGACTTTCGGGTCTTTATCCTAA -> TGACTTTCGGGTCTTTATCCTAAT
CACTTAATCGTCCCTATAGCCCTG -> ACTTAATCGTCCCTATAGCCCTGA
CATACTCGCTTTCAGTGCTAGGAA -> ATACTCGCTTTCAGTGCTAGGAAC
GTAGACGGGCAGTGTGGCTAATCG -> TAGACGGGCAGTGTGGCTAATCGC
GAGCGATCTACAAAGTTAACTGGG -> AGCGATCTACAAAGTTAACTGGGC
CATGCACCAGGATACGCTTAGAGG -> ATGCACCAGGATACGCTTAGAGGT
CCATTTGCAAGAACAATGTGTTAG -> CATTTGCAAGAACAATGTGTTAGT
ATAATGGAATATACGAGACACAAG -> TAATGGAATATACGAGACACAAGA
GGATGTATCGATACCACATGGCGG -> GATGTATCGATACCACATGGCGGT
CAAAGTTAACTGGGCGAGCTGCGA -> AAAGTTAACTGGGCGAGCTGCGAG
CTACCAAGGTGCCACGTGAAACGG -> TACCAAGGTGCCACGTGAAACGGT
TTCCCTCGCTCGCCCGAGAGTCAC -> TCCCTCGCTCGCCCGAGAGTCACT
ACAAAGTTAACTGGGCGAGCTGCG -> CAAAGTTAACTGGGCGAGCTGCGA
TGGTGTGCATAGGACCAGTACGTA -> GGTGTGCATAGGACCAGTACGTAT
CCAAGGAGTGAGAGAGCGTCATAG -> CAAGGAGTGAGAGAGCGTCATAGA
TACAAAGTTAACTGGGCGAGCTGC -> ACAAAGTTAACTGGGCGAGCTGCG
CCTCTTTACGTCACATGACCGTTG -> CTCTTTACGTCACATGACCGTTGC
CTGTCCGGCAGCCTTCCTAATTTT -> TGTCCGGCAGCCTTCCTAATTTTT
CACAAGAGGCAATCGACGAGCGAT -> ACAAGAGGCAATCGACGAGCGATC
GTAATCGTTTTGGATATCTGTGGG -> TAATCGTTTTGGATATCTGTGGGT
TATTGATTAGATCATCAGGTATAG -> ATTGATTAGATCATCAGGTATAGC
ATTAGATCATCAGGTATAGCTCGT -> TTAGATCATCAGGTATAGCTCGTT
CGTGAAGGTCAGAAGCCATAGAGT -> GTGAAGGTCAGAAGCCATAGAGTT
TACTTGTGTTGACAATTACTCGGG -> ACTTGTGTTGACAATTACTCGGGT
GATAATTCGATGTTATGTTAGCGA -> ATAATTCGATGTTATGTTAGCGAA
CAGCACCAGGTCTTGGTGTGCATA -> AGCACCAGGTCTTGGTGTGCATAG
GTTATTAGCAGGGTCTCCTATAGC -> TTATTAGCAGGGTCTCCTATAGCG
CTGGCTGTGCGATGTAGACATTTT -> TGGCTGTGCGATGTAGACATTTTA
TCCGTTGCCAAGCTTGATTTCGAA -> CCGTTGCCAAGCTTGATTTCGAAA
ATAGAAACTCAGCACCAGGTCTTG -> TAGAAACTCAGCACCAGGTCTTGG
GTGAACGTTGTTATGAATCGACGC -> TGAACGTTGTTATGAATCGACGCT
GAACAGAGTAATCGTTTTGGATAT -> AACAGAGTAATCGTTTTGGATATC
ATAGCTCGTTGAACTGTCACGTAA -> TAGCTCGTTGAACTGTCACGTAAT
GTATCTCTACTCGTGAAGGTCAGA -> TATCTCTACTCGTGAAGGTCAGAA
AGAGAGTCAGTACATTTCAGCGTC -> GAGAGTCAGTACATTTCAGCGTCA
TTCGCATTGAATGTATTACGTTTG -> TCGCATTGAATGTATTACGTTTGC
AGTACGTATCTCTACTCGTGAAGG -> GTACGTATCTCTACTCGTGAAGGT
AGTTAAAAATGTGGCCCCTGTGAC -> GTTAAAAATGTGGCCCCTGTGACG
TATTCATCCGTTGCCAAGCTTGAT -> ATTCATCCGTTGCCAAGCTTGATT
CGGGCACCAGCAGTTGTCTGTTTA -> GGGCACCAGCAGTTGTCTGTTTAT
CTATGTGACTTTCGGGTCTTTATC -> TATGTGACTTTCGGGTCTTTATCC
CCTATGCTAGGCACGCACTAGACC -> CTATGCTAGGCACGCACTAGACCG
CGCGAGGAATACCTCATCGGGGTG -> GCGAGGAATACCTCATCGGGGTGA
GCTTTACCCGTAGTTAAAAATGTG -> CTTTACCCGTAGTTAAAAATGTGG
GTTAGACCGGTTCCGGAAACTAGA -> TTAGACCGGTTCCGGAAACTAGAC
CACTGAACCTGGCTGTGCGATGTA -> ACTGAACCTGGCTGTGCGATGTAG
CACCCGGCTGATTCTGCATATTGC -> ACCCGGCTGATTCTGCATATTGCC
AGGCTACTATGTGACTTTCGGGTC -> GGCTACTATGTGACTTTCGGGTCT
AAAAATGTGGCCCCTGTGACGATC -> AAAATGTGGCCCCTGTGACGATCC
CTCAGCCTGGACACTGAACCTGGC -> TCAGCCTGGACACTGAACCTGGCT
GTAGCCGCTTACCCTTTCGCATGC -> TAGCCGCTTACCCTTTCGCATGCG
CCCCCCAATAGGCTACTATGTGAC -> CCCCCAATAGGCTACTATGTGACT
CCCTTCCACTTAATCGTCCCTATA -> CCTTCCACTTAATCGTCCCTATAG
TTCTTCGGTTGGCCTTTCGCATTG -> TCTTCGGTTGGCCTTTCGCATTGA
TACGCGGACTCCTATAATAAAAAT -> ACGCGGACTCCTATAATAAAAATC
CCTGGCTGTGCGATGTAGACATTT -> CTGGCTGTGCGATGTAGACATTTT
AGACCAAGAACAAACTTCCTTGGA -> GACCAAGAACAAACTTCCTTGGAT
CGTAATTTCCAGCCGAATCTCCGT -> GTAATTTCCAGCCGAATCTCCGTG
TCCGAGCCTTGAGGTGCGACTTGT -> CCGAGCCTTGAGGTGCGACTTGTT
CCGTGGACGACGCGAGCGACTATA -> CGTGGACGACGCGAGCGACTATAG
GGGCTACCTGGCAACAGAGGCGAA -> GGCTACCTGGCAACAGAGGCGAAC
TCGCTCCCTGATCCGACTCGTGAC -> CGCTCCCTGATCCGACTCGTGACT
GTTCTCCCGAGTGTGTTAGACCGG -> TTCTCCCGAGTGTGTTAGACCGGT
TAATTAGCCGGAAAAGGCGACGAG -> AATTAGCCGGAAAAGGCGACGAGA
GAGGCAATCGACGAGCGATCTACA -> AGGCAATCGACGAGCGATCTACAA
AACAGAGTAATCGTTTTGGATATC -> ACAGAGTAATCGTTTTGGATATCT
TATTTACTTGATATCTACGTGGGA -> ATTTACTTGATATCTACGTGGGAC
TTGATTAGATCATCAGGTATAGCT -> TGATTAGATCATCAGGTATAGCTC
GCTTAAATCATGAACATACGCCCC -> CTTAAATCATGAACATACGCCCCT
CCTTCCTAATTTTTTAGCGCAACT -> CTTCCTAATTTTTTAGCGCAACTA
AATCGTTTTGGATATCTGTGGGTA -> ATCGTTTTGGATATCTGTGGGTAG
AGGTCCATGCAGAATCCATACGCG -> GGTCCATGCAGAATCCATACGCGA
CGCACCATTTGCAAGAACAATGTG -> GCACCATTTGCAAGAACAATGTGT
GACAACCTGAAGACGGGCGTGTAG -> ACAACCTGAAGACGGGCGTGTAGC
GCAGCCTTCCTAATTTTTTAGCGC -> CAGCCTTCCTAATTTTTTAGCGCA
GTATCAAAAAATAGATGGGGCCTA -> TATCAAAAAATAGATGGGGCCTAG
CCTTTCGCATTGAATGTATTACGT -> CTTTCGCATTGAATGTATTACGTT
CGTCATAGACCGCACCATTTGCAA -> GTCATAGACCGCACCATTTGCAAG
ATTCTCGTTACGAACAGAGTAATC -> TTCTCGTTACGAACAGAGTAATCG
ATACTCGCTTTCAGTGCTAGGAAC -> TACTCGCTTTCAGTGCTAGGAACG
TTTAGCGCAACTATTGATTAGATC -> TTAGCGCAACTATTGATTAGATCA
GCCTCGCGGTCTATGCTCTTGCTT -> CCTCGCGGTCTATGCTCTTGCTTT
CTTCTAATTGCGGTGGGGCTACCA -> TTCTAATTGCGGTGGGGCTACCAG
CCTCGGAAAACCGCAATTGGTCCG -> CTCGGAAAACCGCAATTGGTCCGT
CGCTAATTAATAGTACCCGAGAGG -> GCTAATTAATAGTACCCGAGAGGA
TGCCAGTCGGACGGGAGTTGGCGG -> GCCAGTCGGACGGGAGTTGGCGGA
TCTTTATCCTAATGCCTATGCTAG -> CTTTATCCTAATGCCTATGCTAGG
CTAATTAATAGTACCCGAGAGGAT -> TAATTAATAGTACCCGAGAGGATA
GCTAATTAATAGTACCCGAGAGGA -> CTAATTAATAGTACCCGAGAGGAT
TGCAGTGTCGCCAGACCAAGAACA -> GCAGTGTCGCCAGACCAAGAACAA
GAAACTGGCATGCACCAGGATACG -> AAACTGGCATGCACCAGGATACGC
TACCTGGCAACAGAGGCGAACCCC -> ACCTGGCAACAGAGGCGAACCCCG
GTGTTGACAATTACTCGGGTTGCG -> TGTTGACAATTACTCGGGTTGCGA
TGCCTCGCGGTCTATGCTCTTGCT -> GCCTCGCGGTCTATGCTCTTGCTT
TTATTTACTTGATATCTACGTGGG -> TATTTACTTGATATCTACGTGGGA
GGGAGTTGGCGGATTCCCTAGACT -> GGAGTTGGCGGATTCCCTAGACTA
CTATGCTCTTGCTTTTACGCGGAC -> TATGCTCTTGCTTTTACGCGGACT
ATGACCGTTGCCTAGCAGCATGTG -> TGACCGTTGCCTAGCAGCATGTGT
CGGGTTGCGAATCTGAACAATGGC -> GGGTTGCGAATCTGAACAATGGCA
GTTGAACTGTCACGTAATTTCCAG -> TTGAACTGTCACGTAATTTCCAGC
CAATTATTTACTTGATATCTACGT -> AATTATTTACTTGATATCTACGTG
AGAGGCGAACCCCGTTCTCCCGAG -> GAGGCGAACCCCGTTCTCCCGAGT
ATTCTGCATATTGCCATAATTTAC -> TTCTGCATATTGCCATAATTTACA
AGGGGTTGCCGAGTCAGTCGGTAA -> GGGGTTGCCGAGTCAGTCGGTAAC
CTTGTGCTTAAATCATGAACATAC -> TTGTGCTTAAATCATGAACATACG
TATGAGACTAACAGTTGTTTAGAT -> ATGAGACTAACAGTTGTTTAGATA
CATTGAATGTATTACGTTTGCTAG -> ATTGAATGTATTACGTTTGCTAGA
GGTGACGCACTAATATGAGACTAA -> GTGACGCACTAATATGAGACTAAC
CTGAAGACGGGCGTGTAGCCCGAC -> TGAAGACGGGCGTGTAGCCCGACT
TGGACACTGAACCTGGCTGTGCGA -> GGACACTGAACCTGGCTGTGCGAT
GACCGCACCATTTGCAAGAACAAT -> ACCGCACCATTTGCAAGAACAATG
AGGGATGCGGACATGATACCTTCG -> GGGATGCGGACATGATACCTTCGT
TTGTATCAAAAAATAGATGGGGCC -> TGTATCAAAAAATAGATGGGGCCT
TATAGTGGTCCATGCTAGAGAGTC -> ATAGTGGTCCATGCTAGAGAGTCA
ACAAGTGGCTTGATAATGGAATAT -> CAAGTGGCTTGATAATGGAATATA
AAATCATGAACATACGCCCCTCCC -> AATCATGAACATACGCCCCTCCCT
TTATGTTAGCGAATTGTGCCTTTA -> TATGTTAGCGAATTGTGCCTTTAG
ACTAGACTAGATCATTAATATCCT -> CTAGACTAGATCATTAATATCCTC
CCCCCACCCGGCTGATTCTGCATA -> CCCCACCCGGCTGATTCTGCATAT
TGTATTACGTTTGCTAGAAGCGTG -> GTATTACGTTTGCTAGAAGCGTGC
CAGATTGGGGCGCTCCCCCTTGAA -> AGATTGGGGCGCTCCCCCTTGAAG
CAACGTACGCAGGGGTTGCCGAGT -> AACGTACGCAGGGGTTGCCGAGTC
CGGACATGATACCTTCGTGGTCCG -> GGACATGATACCTTCGTGGTCCGA
CCGACAAGTGGCTTGATAATGGAA -> CGACAAGTGGCTTGATAATGGAAT
CTGATCCGACTCGTGACTAAGTCC -> TGATCCGACTCGTGACTAAGTCCT
CTGTCGGTCTAGAGATCACTACCA -> TGTCGGTCTAGAGATCACTACCAA
GGCTCCATTGCACCGCGACAATCT -> GCTCCATTGCACCGCGACAATCTG
TGAACTGTCACGTAATTTCCAGCC -> GAACTGTCACGTAATTTCCAGCCG
CGTTGCCAAGCTTGATTTCGAAAC -> GTTGCCAAGCTTGATTTCGAAACT
GTCACGTAATTTCCAGCCGAATCT -> TCACGTAATTTCCAGCCGAATCTC
GACGAGAAAATACTCTTGTAGCCG -> ACGAGAAAATACTCTTGTAGCCGC
CGCCCCTCTTGAGCGGGCTCCATT -> GCCCCTCTTGAGCGGGCTCCATTG
TGTTGACAATTACTCGGGTTGCGA -> GTTGACAATTACTCGGGTTGCGAA
CTTGTTCTTAAGACGCTAATTAAT -> TTGTTCTTAAGACGCTAATTAATA
TCACGTAATTTCCAGCCGAATCTC -> CACGTAATTTCCAGCCGAATCTCC
TCAGCACCAGGTCTTGGTGTGCAT -> CAGCACCAGGTCTTGGTGTGCATA
GGAATACCTCATCGGGGTGACGCA -> GAATACCTCATCGGGGTGACGCAC
GGGTTGCGAATCTGAACAATGGCA -> GGTTGCGAATCTGAACAATGGCAA
AGAAGGGCTAATTAGCCGGAAAAG -> GAAGGGCTAATTAGCCGGAAAAGG
GCTCCCTGATCCGACTCGTGACTA -> CTCCCTGATCCGACTCGTGACTAA
TGTGTTAGACCGGTTCCGGAAACT -> GTGTTAGACCGGTTCCGGAAACTA
GCTGGGAACGACGCCTAAGACAAC -> CTGGGAACGACGCCTAAGACAACG
GCTACCTGGCAACAGAGGCGAACC -> CTACCTGGCAACAGAGGCGAACCC
TGTGGCTAATCGCTCCCTGATCCG -> GTGGCTAATCGCTCCCTGATCCGA
AATTAATAGTACCCGAGAGGATAA -> ATTAATAGTACCCGAGAGGATAAT
AAGGTCAGAAGCCATAGAGTTTAA -> AGGTCAGAAGCCATAGAGTTTAAG
CACATACTCGCTTTCAGTGCTAGG -> ACATACTCGCTTTCAGTGCTAGGA
TGGGCGAGCTGCGAGGCGCTGTAC -> GGGCGAGCTGCGAGGCGCTGTACA
GTGGATACCTGCTCCCTTGGCTTA -> TGGATACCTGCTCCCTTGGCTTAT
CAGCATGTGTGGAAGTGAACGTTG -> AGCATGTGTGGAAGTGAACGTTGT
CTAGACTACGTCGACTGTAGACGG -> TAGACTACGTCGACTGTAGACGGG
TAACCATTATGTGTGATCACTGCC -> AACCATTATGTGTGATCACTGCCT
CTGTACACCCTTCTAATTGCGGTG -> TGTACACCCTTCTAATTGCGGTGG
CCCCGATATAGAGCATTCTCGTTA -> CCCGATATAGAGCATTCTCGTTAC
CATTATGTGTGATCACTGCCTCGC -> ATTATGTGTGATCACTGCCTCGCG
ACTCGTGACTAAGTCCTCAGCCTG -> CTCGTGACTAAGTCCTCAGCCTGG
GTCTCCCCGATATAGAGCATTCTC -> TCTCCCCGATATAGAGCATTCTCG
TTGTTCTTAAGACGCTAATTAATA -> TGTTCTTAAGACGCTAATTAATAG
TCGTTTTGGATATCTGTGGGTAGC -> CGTTTTGGATATCTGTGGGTAGCA
GTTCCGGAAACTAGACTAGATCAT -> TTCCGGAAACTAGACTAGATCATT
AGGTAAAACGCCGGCGTTATTAGC -> GGTAAAACGCCGGCGTTATTAGCA
CAGCGTCAGTATCCTATAAAGATA -> AGCGTCAGTATCCTATAAAGATAC
TACCTGCTCCCTTGGCTTATCGGC -> ACCTGCTCCCTTGGCTTATCGGCC
TCTGAGTACCTATTCATCCGTTGC -> CTGAGTACCTATTCATCCGTTGCC
TGAAGGTCAGAAGCCATAGAGTTT -> GAAGGTCAGAAGCCATAGAGTTTA
ACCTCATCGGGGTGACGCACTAAT -> CCTCATCGGGGTGACGCACTAATA
CAACCTGAAGACGGGCGTGTAGCC -> AACCTGAAGACGGGCGTGTAGCCC
AATTTACAATTATTTACTTGATAT -> ATTTACAATTATTTACTTGATATC
TGATCACTGCCTCGCGGTCTATGC -> GATCACTGCCTCGCGGTCTATGCT
GATCCGACTCGTGACTAAGTCCTC -> ATCCGACTCGTGACTAAGTCCTCA
CACCAGCAGTTGTCTGTTTATAAA -> ACCAGCAGTTGTCTGTTTATAAAG
GACACAAGAGGCAATCGACGAGCG -> ACACAAGAGGCAATCGACGAGCGA
CTCGGGTTGCGAATCTGAACAATG -> TCGGGTTGCGAATCTGAACAATGG
GATGCCCCTTCCACTTAATCGTCC -> ATGCCCCTTCCACTTAATCGTCCC
GTGCCGGGTTCTTCGGTTGGCCTT -> TGCCGGGTTCTTCGGTTGGCCTTT
CGTCGACTGTAGACGGGCAGTGTG -> GTCGACTGTAGACGGGCAGTGTGG
TGGCGGATTCCCTAGACTACGTCG -> GGCGGATTCCCTAGACTACGTCGA
ACGACGCGAGCGACTATAGTTCCC -> CGACGCGAGCGACTATAGTTCCCT
CCGCTTACCCTTTCGCATGCGAGT -> CGCTTACCCTTTCGCATGCGAGTT
GGCACCAGCAGTTGTCTGTTTATA -> GCACCAGCAGTTGTCTGTTTATAA
GGTGCGACTTGTTCTTAAGACGCT -> GTGCGACTTGTTCTTAAGACGCTA
TAGATCATTAATATCCTCTTTACG -> AGATCATTAATATCCTCTTTACGT
TACCCGTAGTTAAAAATGTGGCCC -> ACCCGTAGTTAAAAATGTGGCCCC
TTAATCGTCCCTATAGCCCTGACA -> TAATCGTCCCTATAGCCCTGACAC
AATTTTTTAGCGCAACTATTGATT -> ATTTTTTAGCGCAACTATTGATTA
TACAATTATTTACTTGATATCTAC -> ACAATTATTTACTTGATATCTACG
GCCCGAGAGTCACTATGGGATGTA -> CCCGAGAGTCACTATGGGATGTAT
CGAGAAAATACTCTTGTAGCCGCT -> GAGAAAATACTCTTGTAGCCGCTT
CATCAGGTATAGCTCGTTGAACTG -> ATCAGGTATAGCTCGTTGAACTGT
CTCGTTACGAACAGAGTAATCGTT -> TCGTTACGAACAGAGTAATCGTTT
GAATGTATTACGTTTGCTAGAAGC -> AATGTATTACGTTTGCTAGAAGCG
CTCGCTTTCAGTGCTAGGAACGTC -> TCGCTTTCAGTGCTAGGAACGTCC
GACTACGTCGACTGTAGACGGGCA -> ACTACGTCGACTGTAGACGGGCAG
ACGTCGACTGTAGACGGGCAGTGT -> CGTCGACTGTAGACGGGCAGTGTG
GTTTAGATATAGAAACTCAGCACC -> TTTAGATATAGAAACTCAGCACCA
TAGCCGGAAAAGGCGACGAGAAAA -> AGCCGGAAAAGGCGACGAGAAAAT
CTCTTGTAGCCGCTTACCCTTTCG -> TCTTGTAGCCGCTTACCCTTTCGC
GCTACATTGTGTGGTGATGCCCCT -> CTACATTGTGTGGTGATGCCCCTT
ACCGCAATTGGTCCGTGGTTGCAA -> CCGCAATTGGTCCGTGGTTGCAAC
AGTGTCGCCAGACCAAGAACAAAC -> GTGTCGCCAGACCAAGAACAAACT
GCCTTGAGGTGCGACTTGTTCTTA -> CCTTGAGGTGCGACTTGTTCTTAA
TGATTAGATCATCAGGTATAGCTC -> GATTAGATCATCAGGTATAGCTCG
TTAAGACGCTAATTAATAGTACCC -> TAAGACGCTAATTAATAGTACCCG
TCATCAGGTATAGCTCGTTGAACT -> CATCAGGTATAGCTCGTTGAACTG
GCGAATCTGAACAATGGCAAGCTA -> CGAATCTGAACAATGGCAAGCTAC
CGTGGATACCTGCTCCCTTGGCTT -> GTGGATACCTGCTCCCTTGGCTTA
TAGTGGTCCATGCTAGAGAGTCAG -> AGTGGTCCATGCTAGAGAGTCAGT
AGAAACTCAGCACCAGGTCTTGGT -> GAAACTCAGCACCAGGTCTTGGTG
GTACCCGAGAGGATAATTCGATGT -> TACCCGAGAGGATAATTCGATGTT
CGGAAAACCGCAATTGGTCCGTGG -> GGAAAACCGCAATTGGTCCGTGGT
TCACACGCATAGCCTGTCCGGCAG -> CACACGCATAGCCTGTCCGGCAGC
GTAGCCCGACTGAACAGGGCCGAT -> TAGCCCGACTGAACAGGGCCGATT
TATACGAGACACAAGAGGCAATCG -> ATACGAGACACAAGAGGCAATCGA
AATTACTCGGGTTGCGAATCTGAA -> ATTACTCGGGTTGCGAATCTGAAC
GACTATAGTTCCCTCGCTCGCCCG -> ACTATAGTTCCCTCGCTCGCCCGA
CATCCGTTGCCAAGCTTGATTTCG -> ATCCGTTGCCAAGCTTGATTTCGA
TCTTCGGTTGGCCTTTCGCATTGA -> CTTCGGTTGGCCTTTCGCATTGAA
ATGTCACACGTGGATACCTGCTCC -> TGTCACACGTGGATACCTGCTCCC
AGCACCAGGTCTTGGTGTGCATAG -> GCACCAGGTCTTGGTGTGCATAGG
ACGCTAATTAATAGTACCCGAGAG -> CGCTAATTAATAGTACCCGAGAGG
CTCTGAGGGATGCGGACATGATAC -> TCTGAGGGATGCGGACATGATACC
CCAGCCGAATCTCCGTGGACGACG -> CAGCCGAATCTCCGTGGACGACGC
ACACTCTTAGTGCCGGGTTCTTCG -> CACTCTTAGTGCCGGGTTCTTCGG
TGCCTTTAGGCTGTTGACAACCTG -> GCCTTTAGGCTGTTGACAACCTGA
CACTACCAAGGTGCCACGTGAAAC -> ACTACCAAGGTGCCACGTGAAACG
ATATAGAAACTCAGCACCAGGTCT -> TATAGAAACTCAGCACCAGGTCTT
TCGACGCTCACACGCATAGCCTGT -> CGACGCTCACACGCATAGCCTGTC
ATATCTGTGGGTAGCAGCCAGAAG -> TATCTGTGGGTAGCAGCCAGAAGG
GCGGTCAACGTACGCAGGGGTTGC -> CGGTCAACGTACGCAGGGGTTGCC
TACCTATTCATCCGTTGCCAAGCT -> ACCTATTCATCCGTTGCCAAGCTT
ATGGGATGTATCGATACCACATGG -> TGGGATGTATCGATACCACATGGC
AGACTACGTCGACTGTAGACGGGC -> GACTACGTCGACTGTAGACGGGCA
CCTATAGCCCTGACACTCTTAGTG -> CTATAGCCCTGACACTCTTAGTGC
TAGTGGTCTAAGAGTCGCGAGGAA -> AGTGGTCTAAGAGTCGCGAGGAAT
CCGTAGTTAAAAATGTGGCCCCTG -> CGTAGTTAAAAATGTGGCCCCTGT
TATCTGTGGGTAGCAGCCAGAAGG -> ATCTGTGGGTAGCAGCCAGAAGGG
CTCCATTGCACCGCGACAATCTGC -> TCCATTGCACCGCGACAATCTGCA
CTGGGCGAGCTGCGAGGCGCTGTA -> TGGGCGAGCTGCGAGGCGCTGTAC
CTCCTATAATAAAAATCCTTTGTA -> TCCTATAATAAAAATCCTTTGTAT
CAGGGCCGATTTATCCCAATCTTG -> AGGGCCGATTTATCCCAATCTTGT
CTCTACTCGTGAAGGTCAGAAGCC -> TCTACTCGTGAAGGTCAGAAGCCA
AGATCTGAGTACCTATTCATCCGT -> GATCTGAGTACCTATTCATCCGTT
CGGACTCCTATAATAAAAATCCTT -> GGACTCCTATAATAAAAATCCTTT
GATACCTTCGTGGTCCGAGCCTTG -> ATACCTTCGTGGTCCGAGCCTTGA
GCCCCCCAATAGGCTACTATGTGA -> CCCCCCAATAGGCTACTATGTGAC
GACAACGGCACTATCGGGCACCAG -> ACAACGGCACTATCGGGCACCAGC
GATTTCGAAACTGGCATGCACCAG -> ATTTCGAAACTGGCATGCACCAGG
GAACCTGGCTGTGCGATGTAGACA -> AACCTGGCTGTGCGATGTAGACAT
ACAATTATTTACTTGATATCTACG -> CAATTATTTACTTGATATCTACGT
GATCATTAATATCCTCTTTACGTC -> ATCATTAATATCCTCTTTACGTCA
TGCTTAAATCATGAACATACGCCC -> GCTTAAATCATGAACATACGCCCC
TATCGGGCACCAGCAGTTGTCTGT -> ATCGGGCACCAGCAGTTGTCTGTT
CGAGCTTTACCCGTAGTTAAAAAT -> GAGCTTTACCCGTAGTTAAAAATG
ATCCTTTGTATCAAAAAATAGATG -> TCCTTTGTATCAAAAAATAGATGG
TTGCCAAGCTTGATTTCGAAACTG -> TGCCAAGCTTGATTTCGAAACTGG
GCGCGAACTTCGTAGGTAACCATT -> CGCGAACTTCGTAGGTAACCATTA
CGGCGTTATTAGCAGGGTCTCCTA -> GGCGTTATTAGCAGGGTCTCCTAT
TTGCAAGAACAATGTGTTAGTGGA -> TGCAAGAACAATGTGTTAGTGGAA
GAGTCAGTCGGTAACACATACTCG -> AGTCAGTCGGTAACACATACTCGC
CAAGCTTGATTTCGAAACTGGCAT -> AAGCTTGATTTCGAAACTGGCATG
GCGAGCGACTATAGTTCCCTCGCT -> CGAGCGACTATAGTTCCCTCGCTC
ACGCATAGCCTGTCCGGCAGCCTT -> CGCATAGCCTGTCCGGCAGCCTTC
CGGGATGTCACACGTGGATACCTG -> GGGATGTCACACGTGGATACCTGC
TAGCCCTGACACTCTTAGTGCCGG -> AGCCCTGACACTCTTAGTGCCGGG
CCGGCTGATTCTGCATATTGCCAT -> CGGCTGATTCTGCATATTGCCATA
AATTTCCAGCCGAATCTCCGTGGA -> ATTTCCAGCCGAATCTCCGTGGAC
AGCATTCTCGTTACGAACAGAGTA -> GCATTCTCGTTACGAACAGAGTAA
TGTATCGATACCACATGGCGGTCA -> GTATCGATACCACATGGCGGTCAA
TTTCGGGTCTTTATCCTAATGCCT -> TTCGGGTCTTTATCCTAATGCCTA
GTCCTCGAGAGACCAAACCCCCAC -> TCCTCGAGAGACCAAACCCCCACC
TAGAGTTTAAGATCTGAGTACCTA -> AGAGTTTAAGATCTGAGTACCTAT
TAGGCTACTATGTGACTTTCGGGT -> AGGCTACTATGTGACTTTCGGGTC
ATGTGGCCCCTGTGACGATCCTGC -> TGTGGCCCCTGTGACGATCCTGCC
GACGGGCGTGTAGCCCGACTGAAC -> ACGGGCGTGTAGCCCGACTGAACA
TAGACCGGTTCCGGAAACTAGACT -> AGACCGGTTCCGGAAACTAGACTA
GTAGTTAAAAATGTGGCCCCTGTG -> TAGTTAAAAATGTGGCCCCTGTGA
TAATTCGATGTTATGTTAGCGAAT -> AATTCGATGTTATGTTAGCGAATT
CATTGTGTGGTGATGCCCCTTCCA -> ATTGTGTGGTGATGCCCCTTCCAC
TGTATCAAAAAATAGATGGGGCCT -> GTATCAAAAAATAGATGGGGCCTA
TAATGCCTATGCTAGGCACGCACT -> AATGCCTATGCTAGGCACGCACTA
CAGTTGTCTGTTTATAAAGGGCTA -> AGTTGTCTGTTTATAAAGGGCTAC
ACTGAACCTGGCTGTGCGATGTAG -> CTGAACCTGGCTGTGCGATGTAGA
TTCTCTGAGGGATGCGGACATGAT -> TCTCTGAGGGATGCGGACATGATA
TGCTAGGAACGTCCTCGAGAGACC -> GCTAGGAACGTCCTCGAGAGACCA
TTACCCGTAGTTAAAAATGTGGCC -> TACCCGTAGTTAAAAATGTGGCCC
AAATCCTTTGTATCAAAAAATAGA -> AATCCTTTGTATCAAAAAATAGAT
TCCGTGGACGACGCGAGCGACTAT -> CCGTGGACGACGCGAGCGACTATA
AGTTGGCGGATTCCCTAGACTACG -> GTTGGCGGATTCCCTAGACTACGT
GCTAGGCACGCACTAGACCGCTAA -> CTAGGCACGCACTAGACCGCTAAT
TGCCCCCCAATAGGCTACTATGTG -> GCCCCCCAATAGGCTACTATGTGA
GTGGTCTAAGAGTCGCGAGGAATA -> TGGTCTAAGAGTCGCGAGGAATAC
CGGGGTGACGCACTAATATGAGAC -> GGGGTGACGCACTAATATGAGACT
CAACGCCCCTCTTGAGCGGGCTCC -> AACGCCCCTCTTGAGCGGGCTCCA
ATCTACAAAGTTAACTGGGCGAGC -> TCTACAAAGTTAACTGGGCGAGCT
GTCCGAGCTTTACCCGTAGTTAAA -> TCCGAGCTTTACCCGTAGTTAAAA
TTAAATCATGAACATACGCCCCTC -> TAAATCATGAACATACGCCCCTCC
ATGTGACTTTCGGGTCTTTATCCT -> TGTGACTTTCGGGTCTTTATCCTA
CGGCACTATCGGGCACCAGCAGTT -> GGCACTATCGGGCACCAGCAGTTG
AGAGCATTCTCGTTACGAACAGAG -> GAGCATTCTCGTTACGAACAGAGT
GTGCTTAAATCATGAACATACGCC -> TGCTTAAATCATGAACATACGCCC
CCATGCTAGAGAGTCAGTACATTT -> CATGCTAGAGAGTCAGTACATTTC
ACTGTCACGTAATTTCCAGCCGAA -> CTGTCACGTAATTTCCAGCCGAAT
CGACTTGTTCTTAAGACGCTAATT -> GACTTGTTCTTAAGACGCTAATTA
TAGACCGCACCATTTGCAAGAACA -> AGACCGCACCATTTGCAAGAACAA
ACTATGGGATGTATCGATACCACA -> CTATGGGATGTATCGATACCACAT
GTCCTCAGCCTGGACACTGAACCT -> TCCTCAGCCTGGACACTGAACCTG
CGTAGGTAACCATTATGTGTGATC -> GTAGGTAACCATTATGTGTGATCA
AAACTTCCTTGGATGCCAGTCGGA -> AACTTCCTTGGATGCCAGTCGGAC
AAAATGTGGCCCCTGTGACGATCC -> AAATGTGGCCCCTGTGACGATCCT
AGACTAACAGTTGTTTAGATATAG -> GACTAACAGTTGTTTAGATATAGA
ACTGGCATGCACCAGGATACGCTT -> CTGGCATGCACCAGGATACGCTTA
ATTGGTCCGTGGTTGCAACGCCCC -> TTGGTCCGTGGTTGCAACGCCCCT
AATTGCGGTGGGGCTACCAGAGCA -> ATTGCGGTGGGGCTACCAGAGCAG
CATTTTAGACTATGCTTTAGGTCC -> ATTTTAGACTATGCTTTAGGTCCG
CAGAATCCATACGCGATACCTAGG -> AGAATCCATACGCGATACCTAGGC
CCTCCCTTGCGGGATGTCACACGT -> CTCCCTTGCGGGATGTCACACGTG
GCAACAGAGGCGAACCCCGTTCTC -> CAACAGAGGCGAACCCCGTTCTCC
ATTGCGGTGGGGCTACCAGAGCAG -> TTGCGGTGGGGCTACCAGAGCAGT
ACACTGAACCTGGCTGTGCGATGT -> CACTGAACCTGGCTGTGCGATGTA
GATCTACAAAGTTAACTGGGCGAG -> ATCTACAAAGTTAACTGGGCGAGC
ATGGAATATACGAGACACAAGAGG -> TGGAATATACGAGACACAAGAGGC
CTTTACCCGTAGTTAAAAATGTGG -> TTTACCCGTAGTTAAAAATGTGGC
TTAGCGAATTGTGCCTTTAGGCTG -> TAGCGAATTGTGCCTTTAGGCTGT
GCCCCTGTGACGATCCTGCCCAGA -> CCCCTGTGACGATCCTGCCCAGAT
TAGGTCCGAGCTTTACCCGTAGTT -> AGGTCCGAGCTTTACCCGTAGTTA
TATTACGTTTGCTAGAAGCGTGCA -> ATTACGTTTGCTAGAAGCGTGCAG
AGACGCTAATTAATAGTACCCGAG -> GACGCTAATTAATAGTACCCGAGA
ACTTGTGTTGACAATTACTCGGGT -> CTTGTGTTGACAATTACTCGGGTT
GGCAATCGACGAGCGATCTACAAA -> GCAATCGACGAGCGATCTACAAAG
TGTTATGAATCGACGCTCACACGC -> GTTATGAATCGACGCTCACACGCA
ATCTCCGTGGACGACGCGAGCGAC -> TCTCCGTGGACGACGCGAGCGACT
TACCACATGGCGGTCAACGTACGC -> ACCACATGGCGGTCAACGTACGCA
GTAACCATTATGTGTGATCACTGC -> TAACCATTATGTGTGATCACTGCC
GAACGGCCCAGATATAGTGGTCCA -> AACGGCCCAGATATAGTGGTCCAT
ATCAAAAAATAGATGGGGCCTAGT -> TCAAAAAATAGATGGGGCCTAGTG
GAAACTAGACTAGATCATTAATAT -> AAACTAGACTAGATCATTAATATC
ACGTCACATGACCGTTGCCTAGCA -> CGTCACATGACCGTTGCCTAGCAG
GGAAAACCGCAATTGGTCCGTGGT -> GAAAACCGCAATTGGTCCGTGGTT
TTTCAGCGTCAGTATCCTATAAAG -> TTCAGCGTCAGTATCCTATAAAGA
TGTGTGGAAGTGAACGTTGTTATG -> GTGTGGAAGTGAACGTTGTTATGA
GCACCGCGACAATCTGCAGTGTCG -> CACCGCGACAATCTGCAGTGTCGC
AGCCAGAAGGGCTAATTAGCCGGA -> GCCAGAAGGGCTAATTAGCCGGAA
GTAGGTAACCATTATGTGTGATCA -> TAGGTAACCATTATGTGTGATCAC
AAACGGTTCTCTGAGGGATGCGGA -> AACGGTTCTCTGAGGGATGCGGAC
ATGTTATGTTAGCGAATTGTGCCT -> TGTTATGTTAGCGAATTGTGCCTT
CGTTTGCTAGAAGCGTGCAGCGGA -> GTTTGCTAGAAGCGTGCAGCGGAG
GTTGCCTAGCAGCATGTGTGGAAG -> TTGCCTAGCAGCATGTGTGGAAGT
GACGACGCGAGCGACTATAGTTCC -> ACGACGCGAGCGACTATAGTTCCC
CATTTCAGCGTCAGTATCCTATAA -> ATTTCAGCGTCAGTATCCTATAAA
TCGGCCCTCGGAAAACCGCAATTG -> CGGCCCTCGGAAAACCGCAATTGG
CGAGCCTTGAGGTGCGACTTGTTC -> GAGCCTTGAGGTGCGACTTGTTCT
CGTTTTGGATATCTGTGGGTAGCA -> GTTTTGGATATCTGTGGGTAGCAG
AGTCGCGAGGAATACCTCATCGGG -> GTCGCGAGGAATACCTCATCGGGG
CAGAAGGGCTAATTAGCCGGAAAA -> AGAAGGGCTAATTAGCCGGAAAAG
TCTCCGTGGACGACGCGAGCGACT -> CTCCGTGGACGACGCGAGCGACTA
CGAATCTCCGTGGACGACGCGAGC -> GAATCTCCGTGGACGACGCGAGCG
GGGGTGACGCACTAATATGAGACT -> GGGTGACGCACTAATATGAGACTA
TTTTGGATATCTGTGGGTAGCAGC -> TTTGGATATCTGTGGGTAGCAGCC
ATCATCAGGTATAGCTCGTTGAAC -> TCATCAGGTATAGCTCGTTGAACT
GACACTCTTAGTGCCGGGTTCTTC -> ACACTCTTAGTGCCGGGTTCTTCG
TTATAAAGGGCTACCTGGCAACAG -> TATAAAGGGCTACCTGGCAACAGA
AGTCAGTCGGTAACACATACTCGC -> GTCAGTCGGTAACACATACTCGCT
TAAGACAACGGCACTATCGGGCAC -> AAGACAACGGCACTATCGGGCACC
GAAGTGAACGTTGTTATGAATCGA -> AAGTGAACGTTGTTATGAATCGAC
CAACGGCACTATCGGGCACCAGCA -> AACGGCACTATCGGGCACCAGCAG
GCTCTTGCTTTTACGCGGACTCCT -> CTCTTGCTTTTACGCGGACTCCTA
ACATACTCGCTTTCAGTGCTAGGA -> CATACTCGCTTTCAGTGCTAGGAA
TGTGCTTAAATCATGAACATACGC -> GTGCTTAAATCATGAACATACGCC
TGAGTACCTATTCATCCGTTGCCA -> GAGTACCTATTCATCCGTTGCCAA
GGCTAATTAGCCGGAAAAGGCGAC -> GCTAATTAGCCGGAAAAGGCGACG
GAGCAGTGCCCCCCAATAGGCTAC -> AGCAGTGCCCCCCAATAGGCTACT
TTGTTTAGATATAGAAACTCAGCA -> TGTTTAGATATAGAAACTCAGCAC
GTACGTATCTCTACTCGTGAAGGT -> TACGTATCTCTACTCGTGAAGGTC
TATAAAGGGCTACCTGGCAACAGA -> ATAAAGGGCTACCTGGCAACAGAG
GTGGAAGGGGTGTCTCCCCGATAT -> TGGAAGGGGTGTCTCCCCGATATA
TCTTTACGTCACATGACCGTTGCC -> CTTTACGTCACATGACCGTTGCCT
CAGAGCAGTGCCCCCCAATAGGCT -> AGAGCAGTGCCCCCCAATAGGCTA
GCGACGAGAAAATACTCTTGTAGC -> CGACGAGAAAATACTCTTGTAGCC
TCGGGCACCAGCAGTTGTCTGTTT -> CGGGCACCAGCAGTTGTCTGTTTA
TGTAGACGGGCAGTGTGGCTAATC -> GTAGACGGGCAGTGTGGCTAATCG
TAATTGCGGTGGGGCTACCAGAGC -> AATTGCGGTGGGGCTACCAGAGCA
CAATTACTCGGGTTGCGAATCTGA -> AATTACTCGGGTTGCGAATCTGAA
CTATTCATCCGTTGCCAAGCTTGA -> TATTCATCCGTTGCCAAGCTTGAT
ATAGTTCCCTCGCTCGCCCGAGAG -> TAGTTCCCTCGCTCGCCCGAGAGT
TTGTTATGAATCGACGCTCACACG -> TGTTATGAATCGACGCTCACACGC
GGCCCCTGTGACGATCCTGCCCAG -> GCCCCTGTGACGATCCTGCCCAGA
CGGGTCTTTATCCTAATGCCTATG -> GGGTCTTTATCCTAATGCCTATGC
CTAGACCGCTAATCGCGCGAACTT -> TAGACCGCTAATCGCGCGAACTTC
CTGCAGTGTCGCCAGACCAAGAAC -> TGCAGTGTCGCCAGACCAAGAACA
ACGCTTAGAGGTAAAACGCCGGCG -> CGCTTAGAGGTAAAACGCCGGCGT
CTTGCTTTTACGCGGACTCCTATA -> TTGCTTTTACGCGGACTCCTATAA
TGATACCTTCGTGGTCCGAGCCTT -> GATACCTTCGTGGTCCGAGCCTTG
AAGTGGCTTGATAATGGAATATAC -> AGTGGCTTGATAATGGAATATACG
TATGAATCGACGCTCACACGCATA -> ATGAATCGACGCTCACACGCATAG
CAGTACATTTCAGCGTCAGTATCC -> AGTACATTTCAGCGTCAGTATCCT
CCACATGGCGGTCAACGTACGCAG -> CACATGGCGGTCAACGTACGCAGG
CAGTGCCCCCCAATAGGCTACTAT -> AGTGCCCCCCAATAGGCTACTATG
TGCCTATGCTAGGCACGCACTAGA -> GCCTATGCTAGGCACGCACTAGAC
AAACTGGCATGCACCAGGATACGC -> AACTGGCATGCACCAGGATACGCT
TTCGGTTGGCCTTTCGCATTGAAT -> TCGGTTGGCCTTTCGCATTGAATG
GAACGACGCCTAAGACAACGGCAC -> AACGACGCCTAAGACAACGGCACT
TGAAACGGTTCTCTGAGGGATGCG -> GAAACGGTTCTCTGAGGGATGCGG
ATCGCTCCCTGATCCGACTCGTGA -> TCGCTCCCTGATCCGACTCGTGAC
TAATCGCTCCCTGATCCGACTCGT -> AATCGCTCCCTGATCCGACTCGTG
CTCGCTCGCCCGAGAGTCACTATG -> TCGCTCGCCCGAGAGTCACTATGG
ATTATTTACTTGATATCTACGTGG -> TTATTTACTTGATATCTACGTGGG
TGTCCGGCAGCCTTCCTAATTTTT -> GTCCGGCAGCCTTCCTAATTTTTT
ACCCTTCTAATTGCGGTGGGGCTA -> CCCTTCTAATTGCGGTGGGGCTAC
AACCCCGTTCTCCCGAGTGTGTTA -> ACCCCGTTCTCCCGAGTGTGTTAG
AGGAACGTCCTCGAGAGACCAAAC -> GGAACGTCCTCGAGAGACCAAACC
TATGCTAGGCACGCACTAGACCGC -> ATGCTAGGCACGCACTAGACCGCT
AGGCAATCGACGAGCGATCTACAA -> GGCAATCGACGAGCGATCTACAAA
TGTAGCCCGACTGAACAGGGCCGA -> GTAGCCCGACTGAACAGGGCCGAT
AGCCCGACTGAACAGGGCCGATTT -> GCCCGACTGAACAGGGCCGATTTA
CGCTCCCTGATCCGACTCGTGACT -> GCTCCCTGATCCGACTCGTGACTA
TAACACATACTCGCTTTCAGTGCT -> AACACATACTCGCTTTCAGTGCTA
GCCCAGATTGGGGCGCTCCCCCTT -> CCCAGATTGGGGCGCTCCCCCTTG
TTCTTAAGACGCTAATTAATAGTA -> TCTTAAGACGCTAATTAATAGTAC
TAGAGAGTCAGTACATTTCAGCGT -> AGAGAGTCAGTACATTTCAGCGTC
TACTCGGGTTGCGAATCTGAACAA -> ACTCGGGTTGCGAATCTGAACAAT
CTCTTGCTTTTACGCGGACTCCTA -> TCTTGCTTTTACGCGGACTCCTAT
CGAGCGACTATAGTTCCCTCGCTC -> GAGCGACTATAGTTCCCTCGCTCG
GATATAGAGCATTCTCGTTACGAA -> ATATAGAGCATTCTCGTTACGAAC
CGAATTGTGCCTTTAGGCTGTTGA -> GAATTGTGCCTTTAGGCTGTTGAC
TAATAAAAATCCTTTGTATCAAAA -> AATAAAAATCCTTTGTATCAAAAA
GGCGTTATTAGCAGGGTCTCCTAT -> GCGTTATTAGCAGGGTCTCCTATA
TTTAGGTCCGAGCTTTACCCGTAG -> TTAGGTCCGAGCTTTACCCGTAGT
GTTAAAAATGTGGCCCCTGTGACG -> TTAAAAATGTGGCCCCTGTGACGA
AGATATAGTGGTCCATGCTAGAGA -> GATATAGTGGTCCATGCTAGAGAG
TGCTAGAGAGTCAGTACATTTCAG -> GCTAGAGAGTCAGTACATTTCAGC
TTCCACTTAATCGTCCCTATAGCC -> TCCACTTAATCGTCCCTATAGCCC
GACGCCTAAGACAACGGCACTATC -> ACGCCTAAGACAACGGCACTATCG
AGTGCCCCCCAATAGGCTACTATG -> GTGCCCCCCAATAGGCTACTATGT
ATAGCCCTGACACTCTTAGTGCCG -> TAGCCCTGACACTCTTAGTGCCGG
AATCGTCCCTATAGCCCTGACACT -> ATCGTCCCTATAGCCCTGACACTC
CGGTCAACGTACGCAGGGGTTGCC -> GGTCAACGTACGCAGGGGTTGCCG
CCCTCTTGAGCGGGCTCCATTGCA -> CCTCTTGAGCGGGCTCCATTGCAC
TCACTATGGGATGTATCGATACCA -> CACTATGGGATGTATCGATACCAC
TACGCTTAGAGGTAAAACGCCGGC -> ACGCTTAGAGGTAAAACGCCGGCG
GACAAGTGGCTTGATAATGGAATA -> ACAAGTGGCTTGATAATGGAATAT
CATAGACCGCACCATTTGCAAGAA -> ATAGACCGCACCATTTGCAAGAAC
AAACTAGACTAGATCATTAATATC -> AACTAGACTAGATCATTAATATCC
CTCGGAAAACCGCAATTGGTCCGT -> TCGGAAAACCGCAATTGGTCCGTG
GTGCCCCCCAATAGGCTACTATGT -> TGCCCCCCAATAGGCTACTATGTG
TCTGAGGGATGCGGACATGATACC -> CTGAGGGATGCGGACATGATACCT
AGTTCCCTCGCTCGCCCGAGAGTC -> GTTCCCTCGCTCGCCCGAGAGTCA
TGTGCCTTTAGGCTGTTGACAACC -> GTGCCTTTAGGCTGTTGACAACCT
TCTCTGAGGGATGCGGACATGATA -> CTCTGAGGGATGCGGACATGATAC
CGGACGGGAGTTGGCGGATTCCCT -> GGACGGGAGTTGGCGGATTCCCTA
TTGAGGTGCGACTTGTTCTTAAGA -> TGAGGTGCGACTTGTTCTTAAGAC
ACGGGAGTTGGCGGATTCCCTAGA -> CGGGAGTTGGCGGATTCCCTAGAC
CGACTGAACAGGGCCGATTTATCC -> GACTGAACAGGGCCGATTTATCCC
GTCGGTAACACATACTCGCTTTCA -> TCGGTAACACATACTCGCTTTCAG
AAATGTGGCCCCTGTGACGATCCT -> AATGTGGCCCCTGTGACGATCCTG
CCGAGCCTTGAGGTGCGACTTGTT -> CGAGCCTTGAGGTGCGACTTGTTC
AATACTCTTGTAGCCGCTTACCCT -> ATACTCTTGTAGCCGCTTACCCTT
GCTGAACGGCCCAGATATAGTGGT -> CTGAACGGCCCAGATATAGTGGTC
GCCTTTAGGCTGTTGACAACCTGA -> CCTTTAGGCTGTTGACAACCTGAA
TGTGGGTAGCAGCCAGAAGGGCTA -> GTGGGTAGCAGCCAGAAGGGCTAA
TCGTCCCTATAGCCCTGACACTCT -> CGTCCCTATAGCCCTGACACTCTT
ATGGCGGTCAACGTACGCAGGGGT -> TGGCGGTCAACGTACGCAGGGGTT
AGTGCCGGGTTCTTCGGTTGGCCT -> GTGCCGGGTTCTTCGGTTGGCCTT
CGCGAGCGACTATAGTTCCCTCGC -> GCGAGCGACTATAGTTCCCTCGCT
CTTGATTTCGAAACTGGCATGCAC -> TTGATTTCGAAACTGGCATGCACC
GTGGGACCGACAAGTGGCTTGATA -> TGGGACCGACAAGTGGCTTGATAA
ACCCTTTCGCATGCGAGTTATCAG -> CCCTTTCGCATGCGAGTTATCAGG
CTCACACGCATAGCCTGTCCGGCA -> TCACACGCATAGCCTGTCCGGCAG
TCAGTGCTAGGAACGTCCTCGAGA -> CAGTGCTAGGAACGTCCTCGAGAG
ACTATAGTTCCCTCGCTCGCCCGA -> CTATAGTTCCCTCGCTCGCCCGAG
TCACATGACCGTTGCCTAGCAGCA -> CACATGACCGTTGCCTAGCAGCAT
TTAGATATAGAAACTCAGCACCAG -> TAGATATAGAAACTCAGCACCAGG
TATCCTCTTTACGTCACATGACCG -> ATCCTCTTTACGTCACATGACCGT
GGCACGCACTAGACCGCTAATCGC -> GCACGCACTAGACCGCTAATCGCG
TGTTATGTTAGCGAATTGTGCCTT -> GTTATGTTAGCGAATTGTGCCTTT
GTTAACTGGGCGAGCTGCGAGGCG -> TTAACTGGGCGAGCTGCGAGGCGC
TTATGTGTGATCACTGCCTCGCGG -> TATGTGTGATCACTGCCTCGCGGT
CCTAGACTACGTCGACTGTAGACG -> CTAGACTACGTCGACTGTAGACGG
ACGTACGCAGGGGTTGCCGAGTCA -> CGTACGCAGGGGTTGCCGAGTCAG
CGATTTATCCCAATCTTGTGCTTA -> GATTTATCCCAATCTTGTGCTTAA
TACCAGAGCAGTGCCCCCCAATAG -> ACCAGAGCAGTGCCCCCCAATAGG
GAACATACGCCCCTCCCTTGCGGG -> AACATACGCCCCTCCCTTGCGGGA
GCGAGCTGCGAGGCGCTGTACACC -> CGAGCTGCGAGGCGCTGTACACCC
GATGTAGACATTTTAGACTATGCT -> ATGTAGACATTTTAGACTATGCTT
TGGATATCTGTGGGTAGCAGCCAG -> GGATATCTGTGGGTAGCAGCCAGA
CGGCCCAGATATAGTGGTCCATGC -> GGCCCAGATATAGTGGTCCATGCT
AGGTCAGAAGCCATAGAGTTTAAG -> GGTCAGAAGCCATAGAGTTTAAGA
TTACGCGGACTCCTATAATAAAAA -> TACGCGGACTCCTATAATAAAAAT
TCTGTTTATAAAGGGCTACCTGGC -> CTGTTTATAAAGGGCTACCTGGCA
CCCTGTCGGTCTAGAGATCACTAC -> CCTGTCGGTCTAGAGATCACTACC
ACAGAGTAATCGTTTTGGATATCT -> CAGAGTAATCGTTTTGGATATCTG
GCGGGATGTCACACGTGGATACCT -> CGGGATGTCACACGTGGATACCTG
TGCGAGGCGCTGTACACCCTTCTA -> GCGAGGCGCTGTACACCCTTCTAA
GCGGACATGATACCTTCGTGGTCC -> CGGACATGATACCTTCGTGGTCCG
GTGAAGGTCAGAAGCCATAGAGTT -> TGAAGGTCAGAAGCCATAGAGTTT
GGTCAACGTACGCAGGGGTTGCCG -> GTCAACGTACGCAGGGGTTGCCGA
TTATCGGCCCTCGGAAAACCGCAA -> TATCGGCCCTCGGAAAACCGCAAT
GTCGGTCTAGAGATCACTACCAAG -> TCGGTCTAGAGATCACTACCAAGG
CCCCTTCCACTTAATCGTCCCTAT -> CCCTTCCACTTAATCGTCCCTATA
GCTGTACACCCTTCTAATTGCGGT -> CTGTACACCCTTCTAATTGCGGTG
CAGAAGCCATAGAGTTTAAGATCT -> AGAAGCCATAGAGTTTAAGATCTG
TCTGCAGTGTCGCCAGACCAAGAA -> CTGCAGTGTCGCCAGACCAAGAAC
AGAAAATACTCTTGTAGCCGCTTA -> GAAAATACTCTTGTAGCCGCTTAC
TCGATGTTATGTTAGCGAATTGTG -> CGATGTTATGTTAGCGAATTGTGC
AGTGAACGTTGTTATGAATCGACG -> GTGAACGTTGTTATGAATCGACGC
GTGTAGCCCGACTGAACAGGGCCG -> TGTAGCCCGACTGAACAGGGCCGA
AGCCGGAAAAGGCGACGAGAAAAT -> GCCGGAAAAGGCGACGAGAAAATA
GAATTGTGCCTTTAGGCTGTTGAC -> AATTGTGCCTTTAGGCTGTTGACA
GAGATCACTACCAAGGTGCCACGT -> AGATCACTACCAAGGTGCCACGTG
AGAGTAATCGTTTTGGATATCTGT -> GAGTAATCGTTTTGGATATCTGTG
GCTTTTACGCGGACTCCTATAATA -> CTTTTACGCGGACTCCTATAATAA
TAGCCTGTCCGGCAGCCTTCCTAA -> AGCCTGTCCGGCAGCCTTCCTAAT
TGATATCTACGTGGGACCGACAAG -> GATATCTACGTGGGACCGACAAGT
CCAGACCAAGAACAAACTTCCTTG -> CAGACCAAGAACAAACTTCCTTGG
AGAACAATGTGTTAGTGGAAGGGG -> GAACAATGTGTTAGTGGAAGGGGT
GACGCTAATTAATAGTACCCGAGA -> ACGCTAATTAATAGTACCCGAGAG
CTTGAGCGGGCTCCATTGCACCGC -> TTGAGCGGGCTCCATTGCACCGCG
GTGTTAGACCGGTTCCGGAAACTA -> TGTTAGACCGGTTCCGGAAACTAG
GATATCTGTGGGTAGCAGCCAGAA -> ATATCTGTGGGTAGCAGCCAGAAG
CTATAGTTCCCTCGCTCGCCCGAG -> TATAGTTCCCTCGCTCGCCCGAGA
GATTGGGGCGCTCCCCCTTGAAGA -> ATTGGGGCGCTCCCCCTTGAAGAT
AAGAGTCGCGAGGAATACCTCATC -> AGAGTCGCGAGGAATACCTCATCG
GTGACGATCCTGCCCAGATTGGGG -> TGACGATCCTGCCCAGATTGGGGC
GGAAAAGGCGACGAGAAAATACTC -> GAAAAGGCGACGAGAAAATACTCT
TGACAACCTGAAGACGGGCGTGTA -> GACAACCTGAAGACGGGCGTGTAG
AGTACCCGAGAGGATAATTCGATG -> GTACCCGAGAGGATAATTCGATGT
TCCTATAATAAAAATCCTTTGTAT -> CCTATAATAAAAATCCTTTGTATC
GCATAGCCTGTCCGGCAGCCTTCC -> CATAGCCTGTCCGGCAGCCTTCCT
CTATAATAAAAATCCTTTGTATCA -> TATAATAAAAATCCTTTGTATCAA
CGAGTGTGTTAGACCGGTTCCGGA -> GAGTGTGTTAGACCGGTTCCGGAA
GCATGTGTGGAAGTGAACGTTGTT -> CATGTGTGGAAGTGAACGTTGTTA
AACTGGGCGAGCTGCGAGGCGCTG -> ACTGGGCGAGCTGCGAGGCGCTGT
AGCATGTGTGGAAGTGAACGTTGT -> GCATGTGTGGAAGTGAACGTTGTT
TAGTGCCGGGTTCTTCGGTTGGCC -> AGTGCCGGGTTCTTCGGTTGGCCT
ATTTTTTAGCGCAACTATTGATTA -> TTTTTTAGCGCAACTATTGATTAG
GTGGACGACGCGAGCGACTATAGT -> TGGACGACGCGAGCGACTATAGTT
AAGCGTGCAGCGGAGCTGGGAACG -> AGCGTGCAGCGGAGCTGGGAACGA
GCCTTTCGCATTGAATGTATTACG -> CCTTTCGCATTGAATGTATTACGT
CGATACCACATGGCGGTCAACGTA -> GATACCACATGGCGGTCAACGTAC
TGTAGCCGCTTACCCTTTCGCATG -> GTAGCCGCTTACCCTTTCGCATGC
ATCCGTTGCCAAGCTTGATTTCGA -> TCCGTTGCCAAGCTTGATTTCGAA
GTGACGCACTAATATGAGACTAAC -> TGACGCACTAATATGAGACTAACA
GGAATATACGAGACACAAGAGGCA -> GAATATACGAGACACAAGAGGCAA
GCGAGGAATACCTCATCGGGGTGA -> CGAGGAATACCTCATCGGGGTGAC
TTGCACCGCGACAATCTGCAGTGT -> TGCACCGCGACAATCTGCAGTGTC
TGCTAGAAGCGTGCAGCGGAGCTG -> GCTAGAAGCGTGCAGCGGAGCTGG
TACATTGTGTGGTGATGCCCCTTC -> ACATTGTGTGGTGATGCCCCTTCC
CTAATTGCGGTGGGGCTACCAGAG -> TAATTGCGGTGGGGCTACCAGAGC
TCAAAAAATAGATGGGGCCTAGTG -> CAAAAAATAGATGGGGCCTAGTGG
CTTGATAATGGAATATACGAGACA -> TTGATAATGGAATATACGAGACAC
GGACTCCTATAATAAAAATCCTTT -> GACTCCTATAATAAAAATCCTTTG
AAACCCCCACCCGGCTGATTCTGC -> AACCCCCACCCGGCTGATTCTGCA
TTGGCCTTTCGCATTGAATGTATT -> TGGCCTTTCGCATTGAATGTATTA
TCAGTACATTTCAGCGTCAGTATC -> CAGTACATTTCAGCGTCAGTATCC
AACTTCGTAGGTAACCATTATGTG -> ACTTCGTAGGTAACCATTATGTGT
GTAAAACGCCGGCGTTATTAGCAG -> TAAAACGCCGGCGTTATTAGCAGG
TTAAAAATGTGGCCCCTGTGACGA -> TAAAAATGTGGCCCCTGTGACGAT
GCCCTCGGAAAACCGCAATTGGTC -> CCCTCGGAAAACCGCAATTGGTCC
GAAAATACTCTTGTAGCCGCTTAC -> AAAATACTCTTGTAGCCGCTTACC
TCCCTGATCCGACTCGTGACTAAG -> CCCTGATCCGACTCGTGACTAAGT
GTGGCCCCTGTGACGATCCTGCCC -> TGGCCCCTGTGACGATCCTGCCCA
AATGCCTATGCTAGGCACGCACTA -> ATGCCTATGCTAGGCACGCACTAG
AAAACGCCGGCGTTATTAGCAGGG -> AAACGCCGGCGTTATTAGCAGGGT
AGACCGCTAATCGCGCGAACTTCG -> GACCGCTAATCGCGCGAACTTCGT
CCCCCAATAGGCTACTATGTGACT -> CCCCAATAGGCTACTATGTGACTT
GTCAGTATCCTATAAAGATACTTG -> TCAGTATCCTATAAAGATACTTGT
CATAATTTACAATTATTTACTTGA -> ATAATTTACAATTATTTACTTGAT
TAGCTCGTTGAACTGTCACGTAAT -> AGCTCGTTGAACTGTCACGTAATT
TTAAGATCTGAGTACCTATTCATC -> TAAGATCTGAGTACCTATTCATCC
CGCTTAGAGGTAAAACGCCGGCGT -> GCTTAGAGGTAAAACGCCGGCGTT
GATGGGGCCTAGTGGTCTAAGAGT -> ATGGGGCCTAGTGGTCTAAGAGTC
CTGAACCTGGCTGTGCGATGTAGA -> TGAACCTGGCTGTGCGATGTAGAC
ATTTCAGCGTCAGTATCCTATAAA -> TTTCAGCGTCAGTATCCTATAAAG
GCGGTGGGGCTACCAGAGCAGTGC -> CGGTGGGGCTACCAGAGCAGTGCC
AAGCTTGATTTCGAAACTGGCATG -> AGCTTGATTTCGAAACTGGCATGC
GTCCGGCAGCCTTCCTAATTTTTT -> TCCGGCAGCCTTCCTAATTTTTTA
GTCACTATGGGATGTATCGATACC -> TCACTATGGGATGTATCGATACCA
GCGCCCTGTCGGTCTAGAGATCAC -> CGCCCTGTCGGTCTAGAGATCACT
TCACACGTGGATACCTGCTCCCTT -> CACACGTGGATACCTGCTCCCTTG
CGCGACAATCTGCAGTGTCGCCAG -> GCGACAATCTGCAGTGTCGCCAGA
AGCCGAATCTCCGTGGACGACGCG -> GCCGAATCTCCGTGGACGACGCGA
AGTGTGTTAGACCGGTTCCGGAAA -> GTGTGTTAGACCGGTTCCGGAAAC
CGATGTTATGTTAGCGAATTGTGC -> GATGTTATGTTAGCGAATTGTGCC
GCCTGGACACTGAACCTGGCTGTG -> CCTGGACACTGAACCTGGCTGTGC
CTTGGCTTATCGGCCCTCGGAAAA -> TTGGCTTATCGGCCCTCGGAAAAC
GGCTAATCGCTCCCTGATCCGACT -> GCTAATCGCTCCCTGATCCGACTC
ACGGCCCAGATATAGTGGTCCATG -> CGGCCCAGATATAGTGGTCCATGC
TCACTGCCTCGCGGTCTATGCTCT -> CACTGCCTCGCGGTCTATGCTCTT
CCGAGAGTCACTATGGGATGTATC -> CGAGAGTCACTATGGGATGTATCG
GTTGTTATGAATCGACGCTCACAC -> TTGTTATGAATCGACGCTCACACG
AGTCAGTACATTTCAGCGTCAGTA -> GTCAGTACATTTCAGCGTCAGTAT
CCGTTGCCAAGCTTGATTTCGAAA -> CGTTGCCAAGCTTGATTTCGAAAC
GAGTCAGTACATTTCAGCGTCAGT -> AGTCAGTACATTTCAGCGTCAGTA
TGTACACCCTTCTAATTGCGGTGG -> GTACACCCTTCTAATTGCGGTGGG
TTAGCAGGGTCTCCTATAGCGCCC -> TAGCAGGGTCTCCTATAGCGCCCT
AGCGCAACTATTGATTAGATCATC -> GCGCAACTATTGATTAGATCATCA
GCCGAATCTCCGTGGACGACGCGA -> CCGAATCTCCGTGGACGACGCGAG
AGGATACGCTTAGAGGTAAAACGC -> GGATACGCTTAGAGGTAAAACGCC
CCAGTACGTATCTCTACTCGTGAA -> CAGTACGTATCTCTACTCGTGAAG
ATTACGTTTGCTAGAAGCGTGCAG -> TTACGTTTGCTAGAAGCGTGCAGC
GGGACCGACAAGTGGCTTGATAAT -> GGACCGACAAGTGGCTTGATAATG
TACGTCGACTGTAGACGGGCAGTG -> ACGTCGACTGTAGACGGGCAGTGT
GCGATGTAGACATTTTAGACTATG -> CGATGTAGACATTTTAGACTATGC
TGTTGACAACCTGAAGACGGGCGT -> GTTGACAACCTGAAGACGGGCGTG
AACCCCCACCCGGCTGATTCTGCA -> ACCCCCACCCGGCTGATTCTGCAT
TTCGAAACTGGCATGCACCAGGAT -> TCGAAACTGGCATGCACCAGGATA
ATATACGAGACACAAGAGGCAATC -> TATACGAGACACAAGAGGCAATCG
GGTCCATGCTAGAGAGTCAGTACA -> GTCCATGCTAGAGAGTCAGTACAT
AACTTCCTTGGATGCCAGTCGGAC -> ACTTCCTTGGATGCCAGTCGGACG
ACTTAATCGTCCCTATAGCCCTGA -> CTTAATCGTCCCTATAGCCCTGAC
ATGAGACTAACAGTTGTTTAGATA -> TGAGACTAACAGTTGTTTAGATAT
CTGCATATTGCCATAATTTACAAT -> TGCATATTGCCATAATTTACAATT
ATCACTACCAAGGTGCCACGTGAA -> TCACTACCAAGGTGCCACGTGAAA
CGACTGTAGACGGGCAGTGTGGCT -> GACTGTAGACGGGCAGTGTGGCTA
GCAGCGGAGCTGGGAACGACGCCT -> CAGCGGAGCTGGGAACGACGCCTA
CCTTCTAATTGCGGTGGGGCTACC -> CTTCTAATTGCGGTGGGGCTACCA
AGATATAGAAACTCAGCACCAGGT -> GATATAGAAACTCAGCACCAGGTC
ACCTGGCTGTGCGATGTAGACATT -> CCTGGCTGTGCGATGTAGACATTT
AACGGCCCAGATATAGTGGTCCAT -> ACGGCCCAGATATAGTGGTCCATG
AAAGGCGACGAGAAAATACTCTTG -> AAGGCGACGAGAAAATACTCTTGT
CATAGGACCAGTACGTATCTCTAC -> ATAGGACCAGTACGTATCTCTACT
CGAGGCGCTGTACACCCTTCTAAT -> GAGGCGCTGTACACCCTTCTAATT
TACTATGTGACTTTCGGGTCTTTA -> ACTATGTGACTTTCGGGTCTTTAT
TCATAGACCGCACCATTTGCAAGA -> CATAGACCGCACCATTTGCAAGAA
GATCTGAGTACCTATTCATCCGTT -> ATCTGAGTACCTATTCATCCGTTG
GGCGCTGTACACCCTTCTAATTGC -> GCGCTGTACACCCTTCTAATTGCG
GCTTTAGGTCCGAGCTTTACCCGT -> CTTTAGGTCCGAGCTTTACCCGTA
CGCTTACCCTTTCGCATGCGAGTT -> GCTTACCCTTTCGCATGCGAGTTA
CTGCCCAGATTGGGGCGCTCCCCC -> TGCCCAGATTGGGGCGCTCCCCCT
ATCCCAATCTTGTGCTTAAATCAT -> TCCCAATCTTGTGCTTAAATCATG
GAGAGACCAAACCCCCACCCGGCT -> AGAGACCAAACCCCCACCCGGCTG
CTAATTTTTTAGCGCAACTATTGA -> TAATTTTTTAGCGCAACTATTGAT
TATGTGACTTTCGGGTCTTTATCC -> ATGTGACTTTCGGGTCTTTATCCT
AGAAGCGTGCAGCGGAGCTGGGAA -> GAAGCGTGCAGCGGAGCTGGGAAC
TGCGAATCTGAACAATGGCAAGCT -> GCGAATCTGAACAATGGCAAGCTA
TTACGTCACATGACCGTTGCCTAG -> TACGTCACATGACCGTTGCCTAGC
GCTCGTTGAACTGTCACGTAATTT -> CTCGTTGAACTGTCACGTAATTTC
AAGATCTGAGTACCTATTCATCCG -> AGATCTGAGTACCTATTCATCCGT
CACCAGGTCTTGGTGTGCATAGGA -> ACCAGGTCTTGGTGTGCATAGGAC
ACCTGAAGACGGGCGTGTAGCCCG -> CCTGAAGACGGGCGTGTAGCCCGA
GCTCACACGCATAGCCTGTCCGGC -> CTCACACGCATAGCCTGTCCGGCA
AAGACGGGCGTGTAGCCCGACTGA -> AGACGGGCGTGTAGCCCGACTGAA
GCACCAGGATACGCTTAGAGGTAA -> CACCAGGATACGCTTAGAGGTAAA
CTGACACTCTTAGTGCCGGGTTCT -> TGACACTCTTAGTGCCGGGTTCTT
TAGCCCGACTGAACAGGGCCGATT -> AGCCCGACTGAACAGGGCCGATTT
CGCACTAGACCGCTAATCGCGCGA -> GCACTAGACCGCTAATCGCGCGAA
ACATTTTAGACTATGCTTTAGGTC -> CATTTTAGACTATGCTTTAGGTCC
GTAATTTCCAGCCGAATCTCCGTG -> TAATTTCCAGCCGAATCTCCGTGG
TTAGTGCCGGGTTCTTCGGTTGGC -> TAGTGCCGGGTTCTTCGGTTGGCC
ATGTGTGATCACTGCCTCGCGGTC -> TGTGTGATCACTGCCTCGCGGTCT
GGCTGTTGACAACCTGAAGACGGG -> GCTGTTGACAACCTGAAGACGGGC
CCTCTTGAGCGGGCTCCATTGCAC -> CTCTTGAGCGGGCTCCATTGCACC
ACCCCCACCCGGCTGATTCTGCAT -> CCCCCACCCGGCTGATTCTGCATA
TTTTACGCGGACTCCTATAATAAA -> TTTACGCGGACTCCTATAATAAAA
CTGAACAATGGCAAGCTACATTGT -> TGAACAATGGCAAGCTACATTGTG
GCTAATCGCTCCCTGATCCGACTC -> CTAATCGCTCCCTGATCCGACTCG
ATTAGCCGGAAAAGGCGACGAGAA -> TTAGCCGGAAAAGGCGACGAGAAA
ATCCTAATGCCTATGCTAGGCACG -> TCCTAATGCCTATGCTAGGCACGC
TTTCGCATGCGAGTTATCAGGTCC -> TTCGCATGCGAGTTATCAGGTCCA
CAGGGTCTCCTATAGCGCCCTGTC -> AGGGTCTCCTATAGCGCCCTGTCG
GCAGTGTGGCTAATCGCTCCCTGA -> CAGTGTGGCTAATCGCTCCCTGAT
TGTGTGATCACTGCCTCGCGGTCT -> GTGTGATCACTGCCTCGCGGTCTA
CCATTATGTGTGATCACTGCCTCG -> CATTATGTGTGATCACTGCCTCGC
TGCCAAGCTTGATTTCGAAACTGG -> GCCAAGCTTGATTTCGAAACTGGC
TTTCAGTGCTAGGAACGTCCTCGA -> TTCAGTGCTAGGAACGTCCTCGAG
ACGCCCCTCTTGAGCGGGCTCCAT -> CGCCCCTCTTGAGCGGGCTCCATT
GCTAATTAGCCGGAAAAGGCGACG -> CTAATTAGCCGGAAAAGGCGACGA
TGTGGTGATGCCCCTTCCACTTAA -> GTGGTGATGCCCCTTCCACTTAAT
GGTCAGAAGCCATAGAGTTTAAGA -> GTCAGAAGCCATAGAGTTTAAGAT
GCAAGCTACATTGTGTGGTGATGC -> CAAGCTACATTGTGTGGTGATGCC
TCACTACCAAGGTGCCACGTGAAA -> CACTACCAAGGTGCCACGTGAAAC
TGCAACGCCCCTCTTGAGCGGGCT -> GCAACGCCCCTCTTGAGCGGGCTC
GGGATGCGGACATGATACCTTCGT -> GGATGCGGACATGATACCTTCGTG
ATTTCCAGCCGAATCTCCGTGGAC -> TTTCCAGCCGAATCTCCGTGGACG
GATGTATCGATACCACATGGCGGT -> ATGTATCGATACCACATGGCGGTC
CACTATCGGGCACCAGCAGTTGTC -> ACTATCGGGCACCAGCAGTTGTCT
TAGATATAGAAACTCAGCACCAGG -> AGATATAGAAACTCAGCACCAGGT
CGGTTGGCCTTTCGCATTGAATGT -> GGTTGGCCTTTCGCATTGAATGTA
GAGCTTTACCCGTAGTTAAAAATG -> AGCTTTACCCGTAGTTAAAAATGT
TTCTAATTGCGGTGGGGCTACCAG -> TCTAATTGCGGTGGGGCTACCAGA
CATCGGGGTGACGCACTAATATGA -> ATCGGGGTGACGCACTAATATGAG
CAAGGAGTGAGAGAGCGTCATAGA -> AAGGAGTGAGAGAGCGTCATAGAC
GACCGGTTCCGGAAACTAGACTAG -> ACCGGTTCCGGAAACTAGACTAGA
CCTCGCGGTCTATGCTCTTGCTTT -> CTCGCGGTCTATGCTCTTGCTTTT
CCGAGCTTTACCCGTAGTTAAAAA -> CGAGCTTTACCCGTAGTTAAAAAT
CAGTATCCTATAAAGATACTTGTG -> AGTATCCTATAAAGATACTTGTGT
TGCCACGTGAAACGGTTCTCTGAG -> GCCACGTGAAACGGTTCTCTGAGG
CCCTATAGCCCTGACACTCTTAGT -> CCTATAGCCCTGACACTCTTAGTG
GTGGGTAGCAGCCAGAAGGGCTAA -> TGGGTAGCAGCCAGAAGGGCTAAT
CGACAATCTGCAGTGTCGCCAGAC -> GACAATCTGCAGTGTCGCCAGACC
TCCATACGCGATACCTAGGCTGAA -> CCATACGCGATACCTAGGCTGAAC
CGGAGCTGGGAACGACGCCTAAGA -> GGAGCTGGGAACGACGCCTAAGAC
GGTTCTCTGAGGGATGCGGACATG -> GTTCTCTGAGGGATGCGGACATGA
CATGTGTGGAAGTGAACGTTGTTA -> ATGTGTGGAAGTGAACGTTGTTAT
ATACTTGTGTTGACAATTACTCGG -> TACTTGTGTTGACAATTACTCGGG
CGAACTTCGTAGGTAACCATTATG -> GAACTTCGTAGGTAACCATTATGT
TTGGTGTGCATAGGACCAGTACGT -> TGGTGTGCATAGGACCAGTACGTA
CGAGGAATACCTCATCGGGGTGAC -> GAGGAATACCTCATCGGGGTGACG
ACTTCGTAGGTAACCATTATGTGT -> CTTCGTAGGTAACCATTATGTGTG
CAAAAAATAGATGGGGCCTAGTGG -> AAAAAATAGATGGGGCCTAGTGGT
CTACCTGGCAACAGAGGCGAACCC -> TACCTGGCAACAGAGGCGAACCCC
GGTCTCCTATAGCGCCCTGTCGGT -> GTCTCCTATAGCGCCCTGTCGGTC
TTCCGGAAACTAGACTAGATCATT -> TCCGGAAACTAGACTAGATCATTA
GTTGACAACCTGAAGACGGGCGTG -> TTGACAACCTGAAGACGGGCGTGT
ATTGAATGTATTACGTTTGCTAGA -> TTGAATGTATTACGTTTGCTAGAA
ACCTAGGCTGAACGGCCCAGATAT -> CCTAGGCTGAACGGCCCAGATATA
GTTATGAATCGACGCTCACACGCA -> TTATGAATCGACGCTCACACGCAT
AGCAGGGTCTCCTATAGCGCCCTG -> GCAGGGTCTCCTATAGCGCCCTGT
CGCCAGACCAAGAACAAACTTCCT -> GCCAGACCAAGAACAAACTTCCTT
TATAGCTCGTTGAACTGTCACGTA -> ATAGCTCGTTGAACTGTCACGTAA
ACGAGAAAATACTCTTGTAGCCGC -> CGAGAAAATACTCTTGTAGCCGCT
GTGTGGTGATGCCCCTTCCACTTA -> TGTGGTGATGCCCCTTCCACTTAA
ACTCGGGTTGCGAATCTGAACAAT -> CTCGGGTTGCGAATCTGAACAATG
CCAAGGTGCCACGTGAAACGGTTC -> CAAGGTGCCACGTGAAACGGTTCT
TCTCCCGAGTGTGTTAGACCGGTT -> CTCCCGAGTGTGTTAGACCGGTTC
CCCTAGACTACGTCGACTGTAGAC -> CCTAGACTACGTCGACTGTAGACG
ACACAAGAGGCAATCGACGAGCGA -> CACAAGAGGCAATCGACGAGCGAT
TTGATATCTACGTGGGACCGACAA -> TGATATCTACGTGGGACCGACAAG
AACAATGGCAAGCTACATTGTGTG -> ACAATGGCAAGCTACATTGTGTGG
GCGTCAGTATCCTATAAAGATACT -> CGTCAGTATCCTATAAAGATACTT
TTCGTAGGTAACCATTATGTGTGA -> TCGTAGGTAACCATTATGTGTGAT
CTACCAGAGCAGTGCCCCCCAATA -> TACCAGAGCAGTGCCCCCCAATAG
CGGTAACACATACTCGCTTTCAGT -> GGTAACACATACTCGCTTTCAGTG
TCTGCATATTGCCATAATTTACAA -> CTGCATATTGCCATAATTTACAAT
TAGAGCATTCTCGTTACGAACAGA -> AGAGCATTCTCGTTACGAACAGAG
CGAGCGATCTACAAAGTTAACTGG -> GAGCGATCTACAAAGTTAACTGGG
CCCTCGGAAAACCGCAATTGGTCC -> CCTCGGAAAACCGCAATTGGTCCG
CGCCGGCGTTATTAGCAGGGTCTC -> GCCGGCGTTATTAGCAGGGTCTCC
AAGGCGACGAGAAAATACTCTTGT -> AGGCGACGAGAAAATACTCTTGTA
CCGATATAGAGCATTCTCGTTACG -> CGATATAGAGCATTCTCGTTACGA
TCAGGTATAGCTCGTTGAACTGTC -> CAGGTATAGCTCGTTGAACTGTCA
CCCTTCTAATTGCGGTGGGGCTAC -> CCTTCTAATTGCGGTGGGGCTACC
ATCTACGTGGGACCGACAAGTGGC -> TCTACGTGGGACCGACAAGTGGCT
CGCCTAAGACAACGGCACTATCGG -> GCCTAAGACAACGGCACTATCGGG
ACAGTTGTTTAGATATAGAAACTC -> CAGTTGTTTAGATATAGAAACTCA
GCTACTATGTGACTTTCGGGTCTT -> CTACTATGTGACTTTCGGGTCTTT
TTTACTTGATATCTACGTGGGACC -> TTACTTGATATCTACGTGGGACCG
TAGCGAATTGTGCCTTTAGGCTGT -> AGCGAATTGTGCCTTTAGGCTGTT
CTACAAAGTTAACTGGGCGAGCTG -> TACAAAGTTAACTGGGCGAGCTGC
TAAATCATGAACATACGCCCCTCC -> AAATCATGAACATACGCCCCTCCC
ACACCCTTCTAATTGCGGTGGGGC -> CACCCTTCTAATTGCGGTGGGGCT
TAGACTACGTCGACTGTAGACGGG -> AGACTACGTCGACTGTAGACGGGC
GTGCGACTTGTTCTTAAGACGCTA -> TGCGACTTGTTCTTAAGACGCTAA
ACACATACTCGCTTTCAGTGCTAG -> CACATACTCGCTTTCAGTGCTAGG
ATACCTCATCGGGGTGACGCACTA -> TACCTCATCGGGGTGACGCACTAA
AGACACAAGAGGCAATCGACGAGC -> GACACAAGAGGCAATCGACGAGCG
ATTTTAGACTATGCTTTAGGTCCG -> TTTTAGACTATGCTTTAGGTCCGA
ACCGCTAATCGCGCGAACTTCGTA -> CCGCTAATCGCGCGAACTTCGTAG
TTCGGGTCTTTATCCTAATGCCTA -> TCGGGTCTTTATCCTAATGCCTAT
GGGATGTATCGATACCACATGGCG -> GGATGTATCGATACCACATGGCGG
CCGGGTTCTTCGGTTGGCCTTTCG -> CGGGTTCTTCGGTTGGCCTTTCGC
CAACAGAGGCGAACCCCGTTCTCC -> AACAGAGGCGAACCCCGTTCTCCC
GCATTGAATGTATTACGTTTGCTA -> CATTGAATGTATTACGTTTGCTAG
ACCATTATGTGTGATCACTGCCTC -> CCATTATGTGTGATCACTGCCTCG
ATCAGGTCCATGCAGAATCCATAC -> TCAGGTCCATGCAGAATCCATACG
TTTTTAGCGCAACTATTGATTAGA -> TTTTAGCGCAACTATTGATTAGAT
GTGGCTTGATAATGGAATATACGA -> TGGCTTGATAATGGAATATACGAG
ACTTCCTTGGATGCCAGTCGGACG -> CTTCCTTGGATGCCAGTCGGACGG
GGCGGTCAACGTACGCAGGGGTTG -> GCGGTCAACGTACGCAGGGGTTGC
TAGGACCAGTACGTATCTCTACTC -> AGGACCAGTACGTATCTCTACTCG
ATGCCCCTTCCACTTAATCGTCCC -> TGCCCCTTCCACTTAATCGTCCCT
CTATGCTTTAGGTCCGAGCTTTAC -> TATGCTTTAGGTCCGAGCTTTACC
AGGGTCTCCTATAGCGCCCTGTCG -> GGGTCTCCTATAGCGCCCTGTCGG
CTCTTAGTGCCGGGTTCTTCGGTT -> TCTTAGTGCCGGGTTCTTCGGTTG
TCAGGTCCATGCAGAATCCATACG -> CAGGTCCATGCAGAATCCATACGC
CTCCGTGGACGACGCGAGCGACTA -> TCCGTGGACGACGCGAGCGACTAT
TGCGGTGGGGCTACCAGAGCAGTG -> GCGGTGGGGCTACCAGAGCAGTGC
TCCTCTTTACGTCACATGACCGTT -> CCTCTTTACGTCACATGACCGTTG
TCTACTCGTGAAGGTCAGAAGCCA -> CTACTCGTGAAGGTCAGAAGCCAT
TGTTAGCGAATTGTGCCTTTAGGC -> GTTAGCGAATTGTGCCTTTAGGCT
CACTATGGGATGTATCGATACCAC -> ACTATGGGATGTATCGATACCACA
TACGAACAGAGTAATCGTTTTGGA -> ACGAACAGAGTAATCGTTTTGGAT
ATTGCCATAATTTACAATTATTTA -> TTGCCATAATTTACAATTATTTAC
TGGCTTATCGGCCCTCGGAAAACC -> GGCTTATCGGCCCTCGGAAAACCG
TTCTCGTTACGAACAGAGTAATCG -> TCTCGTTACGAACAGAGTAATCGT
TATAGTTCCCTCGCTCGCCCGAGA -> ATAGTTCCCTCGCTCGCCCGAGAG
AAGGGCTAATTAGCCGGAAAAGGC -> AGGGCTAATTAGCCGGAAAAGGCG
TAAAAATCCTTTGTATCAAAAAAT -> AAAAATCCTTTGTATCAAAAAATA
CTTATCGGCCCTCGGAAAACCGCA -> TTATCGGCCCTCGGAAAACCGCAA
CGGTGGGGCTACCAGAGCAGTGCC -> GGTGGGGCTACCAGAGCAGTGCCC
TTGTGCTTAAATCATGAACATACG -> TGTGCTTAAATCATGAACATACGC
AAGGAGTGAGAGAGCGTCATAGAC -> AGGAGTGAGAGAGCGTCATAGACC
GGATTCCCTAGACTACGTCGACTG -> GATTCCCTAGACTACGTCGACTGT
TGCTCCCTTGGCTTATCGGCCCTC -> GCTCCCTTGGCTTATCGGCCCTCG
CCTGATCCGACTCGTGACTAAGTC -> CTGATCCGACTCGTGACTAAGTCC
CCGGCGTTATTAGCAGGGTCTCCT -> CGGCGTTATTAGCAGGGTCTCCTA
ATTCATCCGTTGCCAAGCTTGATT -> TTCATCCGTTGCCAAGCTTGATTT
TTTACAATTATTTACTTGATATCT -> TTACAATTATTTACTTGATATCTA
CGACGCCTAAGACAACGGCACTAT -> GACGCCTAAGACAACGGCACTATC
TTGAACTGTCACGTAATTTCCAGC -> TGAACTGTCACGTAATTTCCAGCC
GTACGCAGGGGTTGCCGAGTCAGT -> TACGCAGGGGTTGCCGAGTCAGTC
CCGGTTCCGGAAACTAGACTAGAT -> CGGTTCCGGAAACTAGACTAGATC
TGTGACGATCCTGCCCAGATTGGG -> GTGACGATCCTGCCCAGATTGGGG
CACCCTTCTAATTGCGGTGGGGCT -> ACCCTTCTAATTGCGGTGGGGCTA
CCCGGCTGATTCTGCATATTGCCA -> CCGGCTGATTCTGCATATTGCCAT
CACACGCATAGCCTGTCCGGCAGC -> ACACGCATAGCCTGTCCGGCAGCC
GGTTGCCGAGTCAGTCGGTAACAC -> GTTGCCGAGTCAGTCGGTAACACA
ACCAGGTCTTGGTGTGCATAGGAC -> CCAGGTCTTGGTGTGCATAGGACC
AGATCACTACCAAGGTGCCACGTG -> GATCACTACCAAGGTGCCACGTGA
ATCCTATAAAGATACTTGTGTTGA -> TCCTATAAAGATACTTGTGTTGAC
CTAATCGCTCCCTGATCCGACTCG -> TAATCGCTCCCTGATCCGACTCGT
GGGGCTACCAGAGCAGTGCCCCCC -> GGGCTACCAGAGCAGTGCCCCCCA
ATCTGCAGTGTCGCCAGACCAAGA -> TCTGCAGTGTCGCCAGACCAAGAA
AGTATCCTATAAAGATACTTGTGT -> GTATCCTATAAAGATACTTGTGTT
CTGAGTACCTATTCATCCGTTGCC -> TGAGTACCTATTCATCCGTTGCCA
TAATTTACAATTATTTACTTGATA -> AATTTACAATTATTTACTTGATAT
AGTACCTATTCATCCGTTGCCAAG -> GTACCTATTCATCCGTTGCCAAGC
CCTAAGACAACGGCACTATCGGGC -> CTAAGACAACGGCACTATCGGGCA
TAGACCGCTAATCGCGCGAACTTC -> AGACCGCTAATCGCGCGAACTTCG
CTATAGCCCTGACACTCTTAGTGC -> TATAGCCCTGACACTCTTAGTGCC
GGATGCCAGTCGGACGGGAGTTGG -> GATGCCAGTCGGACGGGAGTTGGC
CTCCCCGATATAGAGCATTCTCGT -> TCCCCGATATAGAGCATTCTCGTT
TCGCCAGACCAAGAACAAACTTCC -> CGCCAGACCAAGAACAAACTTCCT
AAGGGCTACCTGGCAACAGAGGCG -> AGGGCTACCTGGCAACAGAGGCGA
TGGCAAGCTACATTGTGTGGTGAT -> GGCAAGCTACATTGTGTGGTGATG
TTTTTTAGCGCAACTATTGATTAG -> TTTTTAGCGCAACTATTGATTAGA
CAGTGTGGCTAATCGCTCCCTGAT -> AGTGTGGCTAATCGCTCCCTGATC
GGCTGAACGGCCCAGATATAGTGG -> GCTGAACGGCCCAGATATAGTGGT
CCCCAATAGGCTACTATGTGACTT -> CCCAATAGGCTACTATGTGACTTT
CTCCTATAGCGCCCTGTCGGTCTA -> TCCTATAGCGCCCTGTCGGTCTAG
GGCGACGAGAAAATACTCTTGTAG -> GCGACGAGAAAATACTCTTGTAGC
AGATGGGGCCTAGTGGTCTAAGAG -> GATGGGGCCTAGTGGTCTAAGAGT
GCACCATTTGCAAGAACAATGTGT -> CACCATTTGCAAGAACAATGTGTT
CTAATCGCGCGAACTTCGTAGGTA -> TAATCGCGCGAACTTCGTAGGTAA
CCCGACTGAACAGGGCCGATTTAT -> CCGACTGAACAGGGCCGATTTATC
TTTAAGATCTGAGTACCTATTCAT -> TTAAGATCTGAGTACCTATTCATC
GAGCGACTATAGTTCCCTCGCTCG -> AGCGACTATAGTTCCCTCGCTCGC
CGGGTTCTTCGGTTGGCCTTTCGC -> GGGTTCTTCGGTTGGCCTTTCGCA
GTGAGAGAGCGTCATAGACCGCAC -> TGAGAGAGCGTCATAGACCGCACC
GACGATCCTGCCCAGATTGGGGCG -> ACGATCCTGCCCAGATTGGGGCGC
ACGCACTAATATGAGACTAACAGT -> CGCACTAATATGAGACTAACAGTT
AATCTGAACAATGGCAAGCTACAT -> ATCTGAACAATGGCAAGCTACATT
CAATAGGCTACTATGTGACTTTCG -> AATAGGCTACTATGTGACTTTCGG
TCCGAGCTTTACCCGTAGTTAAAA -> CCGAGCTTTACCCGTAGTTAAAAA
TGATTCTGCATATTGCCATAATTT -> GATTCTGCATATTGCCATAATTTA
ATGAACATACGCCCCTCCCTTGCG -> TGAACATACGCCCCTCCCTTGCGG
GAGGTAAAACGCCGGCGTTATTAG -> AGGTAAAACGCCGGCGTTATTAGC
AGCAGCCAGAAGGGCTAATTAGCC -> GCAGCCAGAAGGGCTAATTAGCCG
TTGAGCGGGCTCCATTGCACCGCG -> TGAGCGGGCTCCATTGCACCGCGA
GGCATGCACCAGGATACGCTTAGA -> GCATGCACCAGGATACGCTTAGAG
TAGCGCCCTGTCGGTCTAGAGATC -> AGCGCCCTGTCGGTCTAGAGATCA
TTATGAATCGACGCTCACACGCAT -> TATGAATCGACGCTCACACGCATA
TTGGCTTATCGGCCCTCGGAAAAC -> TGGCTTATCGGCCCTCGGAAAACC
ATAAAGGGCTACCTGGCAACAGAG -> TAAAGGGCTACCTGGCAACAGAGG
TATCGGCCCTCGGAAAACCGCAAT -> ATCGGCCCTCGGAAAACCGCAATT
TAGAAGCGTGCAGCGGAGCTGGGA -> AGAAGCGTGCAGCGGAGCTGGGAA
TAGAGATCACTACCAAGGTGCCAC -> AGAGATCACTACCAAGGTGCCACG
GCATATTGCCATAATTTACAATTA -> CATATTGCCATAATTTACAATTAT
CTGCGAGGCGCTGTACACCCTTCT -> TGCGAGGCGCTGTACACCCTTCTA
GTGGTGATGCCCCTTCCACTTAAT -> TGGTGATGCCCCTTCCACTTAATC
GTAACACATACTCGCTTTCAGTGC -> TAACACATACTCGCTTTCAGTGCT
AATGTATTACGTTTGCTAGAAGCG -> ATGTATTACGTTTGCTAGAAGCGT
ATACGAGACACAAGAGGCAATCGA -> TACGAGACACAAGAGGCAATCGAC
TTTGCAAGAACAATGTGTTAGTGG -> TTGCAAGAACAATGTGTTAGTGGA
CGTCCCTATAGCCCTGACACTCTT -> GTCCCTATAGCCCTGACACTCTTA
CCCTTTCGCATGCGAGTTATCAGG -> CCTTTCGCATGCGAGTTATCAGGT
CTTAAGACGCTAATTAATAGTACC -> TTAAGACGCTAATTAATAGTACCC
TATGCTCTTGCTTTTACGCGGACT -> ATGCTCTTGCTTTTACGCGGACTC
GCCGGAAAAGGCGACGAGAAAATA -> CCGGAAAAGGCGACGAGAAAATAC
TATCGATACCACATGGCGGTCAAC -> ATCGATACCACATGGCGGTCAACG
CAGGTCTTGGTGTGCATAGGACCA -> AGGTCTTGGTGTGCATAGGACCAG
CCGAATCTCCGTGGACGACGCGAG -> CGAATCTCCGTGGACGACGCGAGC
TAATTTTTTAGCGCAACTATTGAT -> AATTTTTTAGCGCAACTATTGATT
TTGCCTAGCAGCATGTGTGGAAGT -> TGCCTAGCAGCATGTGTGGAAGTG
CTCATCGGGGTGACGCACTAATAT -> TCATCGGGGTGACGCACTAATATG
CTTCGTAGGTAACCATTATGTGTG -> TTCGTAGGTAACCATTATGTGTGA
GAGGTGCGACTTGTTCTTAAGACG -> AGGTGCGACTTGTTCTTAAGACGC
TTAATATCCTCTTTACGTCACATG -> TAATATCCTCTTTACGTCACATGA
GGTCCGAGCTTTACCCGTAGTTAA -> GTCCGAGCTTTACCCGTAGTTAAA
ACCAGTACGTATCTCTACTCGTGA -> CCAGTACGTATCTCTACTCGTGAA
ATATCCTCTTTACGTCACATGACC -> TATCCTCTTTACGTCACATGACCG
GATTAGATCATCAGGTATAGCTCG -> ATTAGATCATCAGGTATAGCTCGT
TGCGGGATGTCACACGTGGATACC -> GCGGGATGTCACACGTGGATACCT
CTAGGCTGAACGGCCCAGATATAG -> TAGGCTGAACGGCCCAGATATAGT
CGGGCTCCATTGCACCGCGACAAT -> GGGCTCCATTGCACCGCGACAATC
AGGAGTGAGAGAGCGTCATAGACC -> GGAGTGAGAGAGCGTCATAGACCG
TAAGAGTCGCGAGGAATACCTCAT -> AAGAGTCGCGAGGAATACCTCATC
CACGCATAGCCTGTCCGGCAGCCT -> ACGCATAGCCTGTCCGGCAGCCTT
AATTATTTACTTGATATCTACGTG -> ATTATTTACTTGATATCTACGTGG
AACCATTATGTGTGATCACTGCCT -> ACCATTATGTGTGATCACTGCCTC
GTGTGATCACTGCCTCGCGGTCTA -> TGTGATCACTGCCTCGCGGTCTAT
TTACTCGGGTTGCGAATCTGAACA -> TACTCGGGTTGCGAATCTGAACAA
CTTCGGTTGGCCTTTCGCATTGAA -> TTCGGTTGGCCTTTCGCATTGAAT
GCCCCTTCCACTTAATCGTCCCTA -> CCCCTTCCACTTAATCGTCCCTAT
CACCAGGATACGCTTAGAGGTAAA -> ACCAGGATACGCTTAGAGGTAAAA
CAGGGGTTGCCGAGTCAGTCGGTA -> AGGGGTTGCCGAGTCAGTCGGTAA
CGGTCTATGCTCTTGCTTTTACGC -> GGTCTATGCTCTTGCTTTTACGCG
CAGTACGTATCTCTACTCGTGAAG -> AGTACGTATCTCTACTCGTGAAGG
CAAGAACAAACTTCCTTGGATGCC -> AAGAACAAACTTCCTTGGATGCCA
CACTCTTAGTGCCGGGTTCTTCGG -> ACTCTTAGTGCCGGGTTCTTCGGT
GCACTAGACCGCTAATCGCGCGAA -> CACTAGACCGCTAATCGCGCGAAC
TCGTAGGTAACCATTATGTGTGAT -> CGTAGGTAACCATTATGTGTGATC
AACAAACTTCCTTGGATGCCAGTC -> ACAAACTTCCTTGGATGCCAGTCG
CACTAATATGAGACTAACAGTTGT -> ACTAATATGAGACTAACAGTTGTT
GACTTTCGGGTCTTTATCCTAATG -> ACTTTCGGGTCTTTATCCTAATGC
TGGCCTTTCGCATTGAATGTATTA -> GGCCTTTCGCATTGAATGTATTAC
AGAAGCCATAGAGTTTAAGATCTG -> GAAGCCATAGAGTTTAAGATCTGA
ACCAAGAACAAACTTCCTTGGATG -> CCAAGAACAAACTTCCTTGGATGC
TTAGCGCAACTATTGATTAGATCA -> TAGCGCAACTATTGATTAGATCAT
GGCCTTTCGCATTGAATGTATTAC -> GCCTTTCGCATTGAATGTATTACG
GCGTCATAGACCGCACCATTTGCA -> CGTCATAGACCGCACCATTTGCAA
TTCATCCGTTGCCAAGCTTGATTT -> TCATCCGTTGCCAAGCTTGATTTC
TGCAGCGGAGCTGGGAACGACGCC -> GCAGCGGAGCTGGGAACGACGCCT
CCAGATATAGTGGTCCATGCTAGA -> CAGATATAGTGGTCCATGCTAGAG
CGCTCGCCCGAGAGTCACTATGGG -> GCTCGCCCGAGAGTCACTATGGGA
AATGTGTTAGTGGAAGGGGTGTCT -> ATGTGTTAGTGGAAGGGGTGTCTC
CACACGTGGATACCTGCTCCCTTG -> ACACGTGGATACCTGCTCCCTTGG
TAGAGGTAAAACGCCGGCGTTATT -> AGAGGTAAAACGCCGGCGTTATTA
CCACCCGGCTGATTCTGCATATTG -> CACCCGGCTGATTCTGCATATTGC
ATGCGAGTTATCAGGTCCATGCAG -> TGCGAGTTATCAGGTCCATGCAGA
CGTGGACGACGCGAGCGACTATAG -> GTGGACGACGCGAGCGACTATAGT
TACACCCTTCTAATTGCGGTGGGG -> ACACCCTTCTAATTGCGGTGGGGC
GCATGCACCAGGATACGCTTAGAG -> CATGCACCAGGATACGCTTAGAGG
