AAAAATGGTAAGATTCTGT -> AAAATGGTAAGATTCTGTT
AAAACCTGCCACTAAGCTC -> AAACCTGCCACTAAGCTCC
AAAACGTTAGAAGTTGGGA -> AAACGTTAGAAGTTGGGAC
AAAACTTTAAGCGTAGGTC -> AAACTTTAAGCGTAGGTCC
AAAAGGTTGCGGCGTTGCA -> AAAGGTTGCGGCGTTGCAC
AAAAGTATGGTTAGCTGCA -> AAAGTATGGTTAGCTGCAG
AAAAGTTTTTCCCGCGCTT -> AAAGTTTTTCCCGCGCTTG
AAAATGGTAAGATTCTGTT -> AAATGGTAAGATTCTGTTA
AAACAATCCGCTCTAGGAA -> AACAATCCGCTCTAGGAAA
AAACAGAAGCTTATCCAGT -> AACAGAAGCTTATCCAGTT
AAACCCATATTCCTTTCGA -> AACCCATATTCCTTTCGAG
AAACCGAGTTCGCGATTGC -> AACCGAGTTCGCGATTGCA
AAACCGATCTTAGCTGAAA -> AACCGATCTTAGCTGAAAT
AAACCTGCCACTAAGCTCC -> AACCTGCCACTAAGCTCCA
AAACCTGCTAGTTATAAGA -> AACCTGCTAGTTATAAGAC
AAACGCGTTGCACCAGTTT -> AACGCGTTGCACCAGTTTG
AAACGTTAGAAGTTGGGAC -> AACGTTAGAAGTTGGGACC
AAACTAGCATCTACTGGCT -> AACTAGCATCTACTGGCTA
AAACTTTAAGCGTAGGTCC -> AACTTTAAGCGTAGGTCCA
AAAGAAACTAGCATCTACT -> AAGAAACTAGCATCTACTG
AAAGAAAGTCAGCGGCGCA -> AAGAAAGTCAGCGGCGCAG
AAAGACCCGGTTGGGATGG -> AAGACCCGGTTGGGATGGG
AAAGCAGTGAGATCACGGA -> AAGCAGTGAGATCACGGAA
AAAGCCCCCGCGGCCCACT -> AAGCCCCCGCGGCCCACTT
AAAGGGGGAGATATATAAG -> AAGGGGGAGATATATAAGG
AAAGGGGTAGATTGCCGTA -> AAGGGGTAGATTGCCGTAG
AAAGGTTGCGGCGTTGCAC -> AAGGTTGCGGCGTTGCACC
AAAGTATGGTTAGCTGCAG -> AAGTATGGTTAGCTGCAGA
AAAGTCAGCGGCGCAGAGT -> AAGTCAGCGGCGCAGAGTG
AAAGTGGACAAATCGACAA -> AAGTGGACAAATCGACAAT
AAAGTTCTTAGCAGGAATA -> AAGTTCTTAGCAGGAATAC
AAAGTTTTTCCCGCGCTTG -> AAGTTTTTCCCGCGCTTGT
AAATAGCCCTACGAGATGA -> AATAGCCCTACGAGATGAA
AAATAGCTGTCATCATAGG -> AATAGCTGTCATCATAGGA
AAATCGACAATTTTCGGAC -> AATCGACAATTTTCGGACG
AAATCGCGCTCGAGTCTGC -> AATCGCGCTCGAGTCTGCT
AAATGCTCGTCTCAATTCC -> AATGCTCGTCTCAATTCCT
AAATGGTAAGATTCTGTTA -> AATGGTAAGATTCTGTTAT
AAATTAGCTGCAGAGTTCA -> AATTAGCTGCAGAGTTCAA
AAATTGTCTGAACGACCGG -> AATTGTCTGAACGACCGGC
AAATTTAGCTGCAGAGTTC -> AATTTAGCTGCAGAGTTCA
AACAAGAAGAACTGAAAAG -> ACAAGAAGAACTGAAAAGT
AACAATCCGCTCTAGGAAA -> ACAATCCGCTCTAGGAAAA
AACACCGCCGACTGCACAC -> ACACCGCCGACTGCACACC
AACAGAAGCTTATCCAGTT -> ACAGAAGCTTATCCAGTTA
AACAGGCGTGAGAATTCGC -> ACAGGCGTGAGAATTCGCG
AACAGGTCATCAAATTTAG -> ACAGGTCATCAAATTTAGC
AACATAAGCCGATTACTCC -> ACATAAGCCGATTACTCCC
AACATGGCAACTCAGAATA -> ACATGGCAACTCAGAATAG
AACCAACCCATCACCTCCA -> ACCAACCCATCACCTCCAC
AACCAAGAAAACCTGCCAC -> ACCAAGAAAACCTGCCACT
AACCACAAGGCTCTTATGT -> ACCACAAGGCTCTTATGTA
AACCCATATTCCTTTCGAG -> ACCCATATTCCTTTCGAGG
AACCCATCACCTCCACGAA -> ACCCATCACCTCCACGAAC
AACCGAGTTCGCGATTGCA -> ACCGAGTTCGCGATTGCAA
AACCGATCTTAGCTGAAAT -> ACCGATCTTAGCTGAAATC
AACCGGGTAGTGCAAGTTC -> ACCGGGTAGTGCAAGTTCA
AACCTAGCTTCTCGTGCTA -> ACCTAGCTTCTCGTGCTAC
AACCTCCGCGCGATGTGAA -> ACCTCCGCGCGATGTGAAC
AACCTGCCACTAAGCTCCA -> ACCTGCCACTAAGCTCCAA
AACCTGCTAGTTATAAGAC -> ACCTGCTAGTTATAAGACC
AACGACCGGCGTAGGGTTC -> ACGACCGGCGTAGGGTTCG
AACGAGCCAGGCTAGCCGA -> ACGAGCCAGGCTAGCCGAG
AACGATCGTTCACCATTCA -> ACGATCGTTCACCATTCAT
AACGATGACAATGTCACTC -> ACGATGACAATGTCACTCA
AACGATTTCCGAATAATAG -> ACGATTTCCGAATAATAGT
AACGCAGGGAGCTACTCAC -> ACGCAGGGAGCTACTCACG
AACGCGTTGCACCAGTTTG -> ACGCGTTGCACCAGTTTGA
AACGGAAGGTTTCTTTAGC -> ACGGAAGGTTTCTTTAGCT
AACGTTAGAAGTTGGGACC -> ACGTTAGAAGTTGGGACCT
AACTAGCATCTACTGGCTA -> ACTAGCATCTACTGGCTAC
AACTATTGACAAATTGTCT -> ACTATTGACAAATTGTCTG
AACTGAAAAGTTTTTCCCG -> ACTGAAAAGTTTTTCCCGC
AACTTTAAGCGTAGGTCCA -> ACTTTAAGCGTAGGTCCAT
AAGAAAACCTGCCACTAAG -> AGAAAACCTGCCACTAAGC
AAGAAACTAGCATCTACTG -> AGAAACTAGCATCTACTGG
AAGAAAGTCAGCGGCGCAG -> AGAAAGTCAGCGGCGCAGA
AAGAACTGAAAAGTTTTTC -> AGAACTGAAAAGTTTTTCC
AAGAAGAACTGAAAAGTTT -> AGAAGAACTGAAAAGTTTT
AAGACCCGGTTGGGATGGG -> AGACCCGGTTGGGATGGGA
AAGACCTTATGAGCGTAAC -> AGACCTTATGAGCGTAACG
AAGAGACAGGTTTGGTCAG -> AGAGACAGGTTTGGTCAGC
AAGATCCGCCAAGGTCCGC -> AGATCCGCCAAGGTCCGCC
AAGATTCTGTTATGTGGGT -> AGATTCTGTTATGTGGGTA
AAGCAAGGAGACAAAGTGG -> AGCAAGGAGACAAAGTGGA
AAGCAGCTAGTAGATATGG -> AGCAGCTAGTAGATATGGA
AAGCAGTGAGATCACGGAA -> AGCAGTGAGATCACGGAAC
AAGCCCCCGCGGCCCACTT -> AGCCCCCGCGGCCCACTTA
AAGCCGATTACTCCCTCGG -> AGCCGATTACTCCCTCGGG
AAGCCTTCGACCAATAACC -> AGCCTTCGACCAATAACCT
AAGCGGGCTCCGCTCGCCC -> AGCGGGCTCCGCTCGCCCT
AAGCGGTTTATTAAGAGAC -> AGCGGTTTATTAAGAGACA
AAGCGTAGGTCCATTGACA -> AGCGTAGGTCCATTGACAC
AAGCTAAACCCATATTCCT -> AGCTAAACCCATATTCCTT
AAGCTCCAAATAGCCCTAC -> AGCTCCAAATAGCCCTACG
AAGCTTATCCAGTTACAAC -> AGCTTATCCAGTTACAACC
AAGGAGACAAAGTGGACAA -> AGGAGACAAAGTGGACAAA
AAGGAGTCTATGGCACACG -> AGGAGTCTATGGCACACGC
AAGGCAGGCTTATGTCTAG -> AGGCAGGCTTATGTCTAGC
AAGGCTCTTATGTATAAGC -> AGGCTCTTATGTATAAGCA
AAGGGGGAGATATATAAGG -> AGGGGGAGATATATAAGGA
AAGGGGTAGATTGCCGTAG -> AGGGGTAGATTGCCGTAGG
AAGGTCCGCCGGTAGGCCG -> AGGTCCGCCGGTAGGCCGG
AAGGTTGCGGCGTTGCACC -> AGGTTGCGGCGTTGCACCA
AAGGTTTCTTTAGCTCATG -> AGGTTTCTTTAGCTCATGT
AAGTATGGTTAGCTGCAGA -> AGTATGGTTAGCTGCAGAG
AAGTCAGCGGCGCAGAGTG -> AGTCAGCGGCGCAGAGTGC
AAGTCATGAGTTATGGACG -> AGTCATGAGTTATGGACGG
AAGTGAAAGTTCTTAGCAG -> AGTGAAAGTTCTTAGCAGG
AAGTGCTGGCACGGGGATG -> AGTGCTGGCACGGGGATGA
AAGTGGACAAATCGACAAT -> AGTGGACAAATCGACAATT
AAGTGGTACTTTCGTGGCT -> AGTGGTACTTTCGTGGCTC
AAGTTCAATCAACGAGCCA -> AGTTCAATCAACGAGCCAG
AAGTTCTTAGCAGGAATAC -> AGTTCTTAGCAGGAATACG
AAGTTGGGACCTTCCTGGC -> AGTTGGGACCTTCCTGGCC
AAGTTTCTCATTCTGTGAT -> AGTTTCTCATTCTGTGATA
AAGTTTTTCCCGCGCTTGT -> AGTTTTTCCCGCGCTTGTG
AATAAAAGGTTGCGGCGTT -> ATAAAAGGTTGCGGCGTTG
AATAACCTAGCTTCTCGTG -> ATAACCTAGCTTCTCGTGC
AATAATAGTGATCACGGGC -> ATAATAGTGATCACGGGCT
AATACGCTCACCTGTGACA -> ATACGCTCACCTGTGACAC
AATAGCCCTACGAGATGAA -> ATAGCCCTACGAGATGAAG
AATAGCTGTCATCATAGGA -> ATAGCTGTCATCATAGGAA
AATAGTGATCACGGGCTGT -> ATAGTGATCACGGGCTGTT
AATCAACGAGCCAGGCTAG -> ATCAACGAGCCAGGCTAGC
AATCAGACTGAAACGCGTT -> ATCAGACTGAAACGCGTTG
AATCCGCTCTAGGAAAACT -> ATCCGCTCTAGGAAAACTT
AATCGACAATTTTCGGACG -> ATCGACAATTTTCGGACGG
AATCGCGCTCGAGTCTGCT -> ATCGCGCTCGAGTCTGCTC
AATGAGGCAAAGACCCGGT -> ATGAGGCAAAGACCCGGTT
AATGCACGCGACCTAAGAT -> ATGCACGCGACCTAAGATC
AATGCTCGTCTCAATTCCT -> ATGCTCGTCTCAATTCCTC
AATGGCATTGCAAGGCAGG -> ATGGCATTGCAAGGCAGGC
AATGGCTAGCTTCTGCGTT -> ATGGCTAGCTTCTGCGTTG
AATGGTAAGATTCTGTTAT -> ATGGTAAGATTCTGTTATG
AATGTCACTCATCGTGGAT -> ATGTCACTCATCGTGGATG
AATTAGCTGCAGAGTTCAA -> ATTAGCTGCAGAGTTCAAT
AATTCCTCAAGTGGTACTT -> ATTCCTCAAGTGGTACTTT
AATTCGCAGACACAGCGTC -> ATTCGCAGACACAGCGTCG
AATTCGCGTCCATGCGAGT -> ATTCGCGTCCATGCGAGTT
AATTGGACTCTACAACGAT -> ATTGGACTCTACAACGATC
AATTGGAGTGAGAGATTTG -> ATTGGAGTGAGAGATTTGA
AATTGTCTGAACGACCGGC -> ATTGTCTGAACGACCGGCG
AATTTAGCTGCAGAGTTCA -> ATTTAGCTGCAGAGTTCAA
AATTTCTCACGGATGCGTT -> ATTTCTCACGGATGCGTTG
AATTTGTCCTCCATCCTAA -> ATTTGTCCTCCATCCTAAC
AATTTTCGGACGGATTAGG -> ATTTTCGGACGGATTAGGC
ACAAAACGTTAGAAGTTGG -> CAAAACGTTAGAAGTTGGG
ACAAAGTGGACAAATCGAC -> CAAAGTGGACAAATCGACA
ACAAATCGACAATTTTCGG -> CAAATCGACAATTTTCGGA
ACAAATTGTCTGAACGACC -> CAAATTGTCTGAACGACCG
ACAACCTCCGCGCGATGTG -> CAACCTCCGCGCGATGTGA
ACAACGATCGTTCACCATT -> CAACGATCGTTCACCATTC
ACAAGAAGAACTGAAAAGT -> CAAGAAGAACTGAAAAGTT
ACAAGGCTCTTATGTATAA -> CAAGGCTCTTATGTATAAG
ACAATCCGCTCTAGGAAAA -> CAATCCGCTCTAGGAAAAC
ACAATGTCACTCATCGTGG -> CAATGTCACTCATCGTGGA
ACAATTCGCAGACACAGCG -> CAATTCGCAGACACAGCGT
ACAATTTTCGGACGGATTA -> CAATTTTCGGACGGATTAG
ACACAGCGTCGTGCTCCAC -> CACAGCGTCGTGCTCCACG
ACACAGTTGGTTCGCCCAT -> CACAGTTGGTTCGCCCATG
ACACCGCCGACTGCACACC -> CACCGCCGACTGCACACCT
ACACCTGTTCAACGATTTC -> CACCTGTTCAACGATTTCC
ACACGCAATGAGGCAAAGA -> CACGCAATGAGGCAAAGAC
ACACTCGTTAGGGAAACCT -> CACTCGTTAGGGAAACCTG
ACAGAAACCGAGTTCGCGA -> CAGAAACCGAGTTCGCGAT
ACAGAAGCTTATCCAGTTA -> CAGAAGCTTATCCAGTTAC
ACAGAGAAACCGATCTTAG -> CAGAGAAACCGATCTTAGC
ACAGCGTCGTGCTCCACGG -> CAGCGTCGTGCTCCACGGG
ACAGGCGTGAGAATTCGCG -> CAGGCGTGAGAATTCGCGT
ACAGGTCATCAAATTTAGC -> CAGGTCATCAAATTTAGCT
ACAGGTTTGGTCAGCGGTG -> CAGGTTTGGTCAGCGGTGG
ACAGTTGGTTCGCCCATGG -> CAGTTGGTTCGCCCATGGT
ACATAAGCCGATTACTCCC -> CATAAGCCGATTACTCCCT
ACATAATGGCATTGCAAGG -> CATAATGGCATTGCAAGGC
ACCAACCCATCACCTCCAC -> CCAACCCATCACCTCCACG
ACCAAGAAAACCTGCCACT -> CCAAGAAAACCTGCCACTA
ACCAATAACCTAGCTTCTC -> CCAATAACCTAGCTTCTCG
ACCACAAGGCTCTTATGTA -> CCACAAGGCTCTTATGTAT
ACCACCCAACAGGCGTGAG -> CCACCCAACAGGCGTGAGA
ACCACTTTCCGCATAAGCA -> CCACTTTCCGCATAAGCAA
ACCAGGGGTAACACCGCCG -> CCAGGGGTAACACCGCCGA
ACCAGTTTGATACCACTTT -> CCAGTTTGATACCACTTTC
ACCAGTTTGATAGCGCCAA -> CCAGTTTGATAGCGCCAAA
ACCAGTTTGATAGGCAGGG -> CCAGTTTGATAGGCAGGGC
ACCAGTTTGATATCATTGT -> CCAGTTTGATATCATTGTG
ACCATTCATACGTGAATGC -> CCATTCATACGTGAATGCA
ACCCAACAGGCGTGAGAAT -> CCCAACAGGCGTGAGAATT
ACCCATATTCCTTTCGAGG -> CCCATATTCCTTTCGAGGC
ACCCATCACCTCCACGAAC -> CCCATCACCTCCACGAACA
ACCCGGTTGGGATGGGAAC -> CCCGGTTGGGATGGGAACA
ACCCTCGCGGTGTGAAAGG -> CCCTCGCGGTGTGAAAGGG
ACCGACCAGGGGTAACACC -> CCGACCAGGGGTAACACCG
ACCGAGTTCGCGATTGCAA -> CCGAGTTCGCGATTGCAAG
ACCGATCTTAGCTGAAATC -> CCGATCTTAGCTGAAATCG
ACCGCACCCTCGCGGTGTG -> CCGCACCCTCGCGGTGTGA
ACCGCCGACTGCACACCTG -> CCGCCGACTGCACACCTGT
ACCGCGGAGGTAGAGGTTA -> CCGCGGAGGTAGAGGTTAG
ACCGGATCCTGGTATACGT -> CCGGATCCTGGTATACGTC
ACCGGCGTAGGGTTCGTGG -> CCGGCGTAGGGTTCGTGGT
ACCGGGTAGTGCAAGTTCA -> CCGGGTAGTGCAAGTTCAA
ACCGTATCGGCGGGCGATG -> CCGTATCGGCGGGCGATGC
ACCTAAGATCCGCCAAGGT -> CCTAAGATCCGCCAAGGTC
ACCTAGCTTCTCGTGCTAC -> CCTAGCTTCTCGTGCTACA
ACCTCAGCCTGGACAGAGA -> CCTCAGCCTGGACAGAGAA
ACCTCCACGAACATGGCAA -> CCTCCACGAACATGGCAAC
ACCTCCGCGCGATGTGAAC -> CCTCCGCGCGATGTGAACA
ACCTGCCACTAAGCTCCAA -> CCTGCCACTAAGCTCCAAA
ACCTGCTAGTTATAAGACC -> CCTGCTAGTTATAAGACCT
ACCTGTGACACAGTTGGTT -> CCTGTGACACAGTTGGTTC
ACCTGTTCAACGATTTCCG -> CCTGTTCAACGATTTCCGA
ACCTTATGAGCGTAACGCA -> CCTTATGAGCGTAACGCAG
ACCTTCCGTACCGACCAGG -> CCTTCCGTACCGACCAGGG
ACCTTCCTGGCCGTGATAC -> CCTTCCTGGCCGTGATACG
ACGAACATGGCAACTCAGA -> CGAACATGGCAACTCAGAA
ACGACCGGCGTAGGGTTCG -> CGACCGGCGTAGGGTTCGT
ACGAGATGAAGCGGGCTCC -> CGAGATGAAGCGGGCTCCG
ACGAGCCAGGCTAGCCGAG -> CGAGCCAGGCTAGCCGAGT
ACGATCGTTCACCATTCAT -> CGATCGTTCACCATTCATA
ACGATGACAATGTCACTCA -> CGATGACAATGTCACTCAT
ACGATTGAAAGCAGTGAGA -> CGATTGAAAGCAGTGAGAT
ACGATTTCCGAATAATAGT -> CGATTTCCGAATAATAGTG
ACGCAATGAGGCAAAGACC -> CGCAATGAGGCAAAGACCC
ACGCAGGGAGCTACTCACG -> CGCAGGGAGCTACTCACGC
ACGCCTTCTATAAAGCCCC -> CGCCTTCTATAAAGCCCCC
ACGCGACCTAAGATCCGCC -> CGCGACCTAAGATCCGCCA
ACGCGTGAAATTAGCTGCA -> CGCGTGAAATTAGCTGCAG
ACGCGTTGCACCAGTTTGA -> CGCGTTGCACCAGTTTGAT
ACGCTCACCTGTGACACAG -> CGCTCACCTGTGACACAGT
ACGCTCGTTTGTTCCCTCA -> CGCTCGTTTGTTCCCTCAT
ACGGAACGATGACAATGTC -> CGGAACGATGACAATGTCA
ACGGAAGGTTTCTTTAGCT -> CGGAAGGTTTCTTTAGCTC
ACGGAGTGGTATCAACCAA -> CGGAGTGGTATCAACCAAC
ACGGATGCGTTGCACCAGT -> CGGATGCGTTGCACCAGTT
ACGGATTAGGCGAAAAGTA -> CGGATTAGGCGAAAAGTAT
ACGGCGTCCTACTTCTACA -> CGGCGTCCTACTTCTACAA
ACGGGAGGACGTGAACCAC -> CGGGAGGACGTGAACCACA
ACGGGCTGTTGCTTAGCTG -> CGGGCTGTTGCTTAGCTGC
ACGGGGATGATAATTGGAG -> CGGGGATGATAATTGGAGT
ACGGGGCCATTTTTTTACG -> CGGGGCCATTTTTTTACGC
ACGGGTCTAGACGGTATCA -> CGGGTCTAGACGGTATCAG
ACGGTATCAGCAGTCGGCA -> CGGTATCAGCAGTCGGCAT
ACGTCGGGTGCAAGTTTCT -> CGTCGGGTGCAAGTTTCTC
ACGTGAACCACAAGGCTCT -> CGTGAACCACAAGGCTCTT
ACGTGAATGCACGCGACCT -> CGTGAATGCACGCGACCTA
ACGTGGGTAATTGGACTCT -> CGTGGGTAATTGGACTCTA
ACGTTAGAAGTTGGGACCT -> CGTTAGAAGTTGGGACCTT
ACTAAAAATGGTAAGATTC -> CTAAAAATGGTAAGATTCT
ACTAAGCTCCAAATAGCCC -> CTAAGCTCCAAATAGCCCT
ACTAGACTCCGATCAGTAA -> CTAGACTCCGATCAGTAAA
ACTAGCATCTACTGGCTAC -> CTAGCATCTACTGGCTACT
ACTAGTTTTACAATTCGCA -> CTAGTTTTACAATTCGCAG
ACTATTGACAAATTGTCTG -> CTATTGACAAATTGTCTGA
ACTCACGCGTGAAATTAGC -> CTCACGCGTGAAATTAGCT
ACTCATCGTGGATGTGGAT -> CTCATCGTGGATGTGGATG
ACTCATGTTACGCCTTCTA -> CTCATGTTACGCCTTCTAT
ACTCCCTCGGGTAACCGGG -> CTCCCTCGGGTAACCGGGT
ACTCCGATCAGTAAATGCT -> CTCCGATCAGTAAATGCTC
ACTCGTTAGGGAAACCTGC -> CTCGTTAGGGAAACCTGCT
ACTCTACAACGATCGTTCA -> CTCTACAACGATCGTTCAC
ACTGAAAAGTTTTTCCCGC -> CTGAAAAGTTTTTCCCGCG
ACTGAAACGCGTTGCACCA -> CTGAAACGCGTTGCACCAG
ACTGCACACCTGTTCAACG -> CTGCACACCTGTTCAACGA
ACTGCTGCATAGGAAAGAA -> CTGCTGCATAGGAAAGAAA
ACTGGACCGTATCGGCGGG -> CTGGACCGTATCGGCGGGC
ACTGGCGTTCATGGTGTTA -> CTGGCGTTCATGGTGTTAC
ACTGGCTACTAAAAATGGT -> CTGGCTACTAAAAATGGTA
ACTTAGCGCTGGCCGATTG -> CTTAGCGCTGGCCGATTGC
ACTTCTACAAAACGTTAGA -> CTTCTACAAAACGTTAGAA
ACTTTAAGCGTAGGTCCAT -> CTTTAAGCGTAGGTCCATT
ACTTTCCGCATAAGCAAGG -> CTTTCCGCATAAGCAAGGA
ACTTTCGTGGCTCTAGTGT -> CTTTCGTGGCTCTAGTGTA
AGAAAACCTGCCACTAAGC -> GAAAACCTGCCACTAAGCT
AGAAACCGAGTTCGCGATT -> GAAACCGAGTTCGCGATTG
AGAAACCGATCTTAGCTGA -> GAAACCGATCTTAGCTGAA
AGAAACTAGCATCTACTGG -> GAAACTAGCATCTACTGGC
AGAAAGTCAGCGGCGCAGA -> GAAAGTCAGCGGCGCAGAG
AGAACTGAAAAGTTTTTCC -> GAACTGAAAAGTTTTTCCC
AGAAGAACTGAAAAGTTTT -> GAAGAACTGAAAAGTTTTT
AGAAGCTTATCCAGTTACA -> GAAGCTTATCCAGTTACAA
AGAAGTTGGGACCTTCCTG -> GAAGTTGGGACCTTCCTGG
AGAATTCGCGTCCATGCGA -> GAATTCGCGTCCATGCGAG
AGACAAAGTGGACAAATCG -> GACAAAGTGGACAAATCGA
AGACACAGCGTCGTGCTCC -> GACACAGCGTCGTGCTCCA
AGACAGGTTTGGTCAGCGG -> GACAGGTTTGGTCAGCGGT
AGACCCGGTTGGGATGGGA -> GACCCGGTTGGGATGGGAA
AGACCTTATGAGCGTAACG -> GACCTTATGAGCGTAACGC
AGACGATTGAAAGCAGTGA -> GACGATTGAAAGCAGTGAG
AGACGGTATCAGCAGTCGG -> GACGGTATCAGCAGTCGGC
AGACTCCGATCAGTAAATG -> GACTCCGATCAGTAAATGC
AGACTGAAACGCGTTGCAC -> GACTGAAACGCGTTGCACC
AGAGAAACCGATCTTAGCT -> GAGAAACCGATCTTAGCTG
AGAGACAGGTTTGGTCAGC -> GAGACAGGTTTGGTCAGCG
AGAGATTTGACCACCCAAC -> GAGATTTGACCACCCAACA
AGAGGTTAGACGATTGAAA -> GAGGTTAGACGATTGAAAG
AGAGTGCGACTGGCGTTCA -> GAGTGCGACTGGCGTTCAT
AGAGTTCAATAAAAGGTTG -> GAGTTCAATAAAAGGTTGC
AGAGTTCAATCAGACTGAA -> GAGTTCAATCAGACTGAAA
AGAGTTCAATGGCTAGCTT -> GAGTTCAATGGCTAGCTTC
AGAGTTCAATTTCTCACGG -> GAGTTCAATTTCTCACGGA
AGATATATAAGGAGTCTAT -> GATATATAAGGAGTCTATG
AGATATGGAGCCTAAACAA -> GATATGGAGCCTAAACAAT
AGATCACGGAACGATGACA -> GATCACGGAACGATGACAA
AGATCCGCCAAGGTCCGCC -> GATCCGCCAAGGTCCGCCG
AGATGAAGCGGGCTCCGCT -> GATGAAGCGGGCTCCGCTC
AGATTCTGTTATGTGGGTA -> GATTCTGTTATGTGGGTAC
AGATTGCCGTAGGGAGTAT -> GATTGCCGTAGGGAGTATA
AGATTTGACCACCCAACAG -> GATTTGACCACCCAACAGG
AGCAACCAAGAAAACCTGC -> GCAACCAAGAAAACCTGCC
AGCAAGGAGACAAAGTGGA -> GCAAGGAGACAAAGTGGAC
AGCAGCTAGTAGATATGGA -> GCAGCTAGTAGATATGGAG
AGCAGGAATACGCTCACCT -> GCAGGAATACGCTCACCTG
AGCAGTCGGCATCCGTTAG -> GCAGTCGGCATCCGTTAGC
AGCAGTGAGATCACGGAAC -> GCAGTGAGATCACGGAACG
AGCATAACAGGTCATCAAA -> GCATAACAGGTCATCAAAT
AGCATCTACTGGCTACTAA -> GCATCTACTGGCTACTAAA
AGCCAGGCTAGCCGAGTAC -> GCCAGGCTAGCCGAGTACT
AGCCCCCGCGGCCCACTTA -> GCCCCCGCGGCCCACTTAG
AGCCCTACGAGATGAAGCG -> GCCCTACGAGATGAAGCGG
AGCCGAGTACTGCTGCATA -> GCCGAGTACTGCTGCATAG
AGCCGATTACTCCCTCGGG -> GCCGATTACTCCCTCGGGT
AGCCGCATATGGGTGGAGG -> GCCGCATATGGGTGGAGGC
AGCCTAAACAATCCGCTCT -> GCCTAAACAATCCGCTCTA
AGCCTAAGTCATGAGTTAT -> GCCTAAGTCATGAGTTATG
AGCCTGGACAGAGAAACCG -> GCCTGGACAGAGAAACCGA
AGCCTTCGACCAATAACCT -> GCCTTCGACCAATAACCTA
AGCGCCAAACAGAAGCTTA -> GCGCCAAACAGAAGCTTAT
AGCGCCCTGGCACTGGACC -> GCGCCCTGGCACTGGACCG
AGCGCTGGCCGATTGCGTC -> GCGCTGGCCGATTGCGTCC
AGCGGCGCAGAGTGCGACT -> GCGGCGCAGAGTGCGACTG
AGCGGGCTCCGCTCGCCCT -> GCGGGCTCCGCTCGCCCTC
AGCGGTGGGTCCTCTACCT -> GCGGTGGGTCCTCTACCTC
AGCGGTTTATTAAGAGACA -> GCGGTTTATTAAGAGACAG
AGCGTAACGCAGGGAGCTA -> GCGTAACGCAGGGAGCTAC
AGCGTAGGTCCATTGACAC -> GCGTAGGTCCATTGACACT
AGCGTCGTGCTCCACGGGG -> GCGTCGTGCTCCACGGGGC
AGCTAAACCCATATTCCTT -> GCTAAACCCATATTCCTTT
AGCTACTCACGCGTGAAAT -> GCTACTCACGCGTGAAATT
AGCTAGTAGATATGGAGCC -> GCTAGTAGATATGGAGCCT
AGCTCATGTGGCGCTGAGT -> GCTCATGTGGCGCTGAGTT
AGCTCCAAATAGCCCTACG -> GCTCCAAATAGCCCTACGA
AGCTGAAATCGCGCTCGAG -> GCTGAAATCGCGCTCGAGT
AGCTGCAGAGTTCAATAAA -> GCTGCAGAGTTCAATAAAA
AGCTGCAGAGTTCAATCAG -> GCTGCAGAGTTCAATCAGA
AGCTGCAGAGTTCAATGGC -> GCTGCAGAGTTCAATGGCT
AGCTGCAGAGTTCAATTTC -> GCTGCAGAGTTCAATTTCT
AGCTGTCATCATAGGAAAG -> GCTGTCATCATAGGAAAGA
AGCTTATCCAGTTACAACC -> GCTTATCCAGTTACAACCT
AGCTTCTCGTGCTACAGAA -> GCTTCTCGTGCTACAGAAA
AGCTTCTGCGTTGCACCAG -> GCTTCTGCGTTGCACCAGT
AGGAAAACTTTAAGCGTAG -> GGAAAACTTTAAGCGTAGG
AGGAAAGAAACTAGCATCT -> GGAAAGAAACTAGCATCTA
AGGAAAGAAAGTCAGCGGC -> GGAAAGAAAGTCAGCGGCG
AGGAATACGCTCACCTGTG -> GGAATACGCTCACCTGTGA
AGGACGTGAACCACAAGGC -> GGACGTGAACCACAAGGCT
AGGAGACAAAGTGGACAAA -> GGAGACAAAGTGGACAAAT
AGGAGTAGCCGCATATGGG -> GGAGTAGCCGCATATGGGT
AGGAGTCTATGGCACACGC -> GGAGTCTATGGCACACGCA
AGGCAAAGACCCGGTTGGG -> GGCAAAGACCCGGTTGGGA
AGGCACGGCGTCCTACTTC -> GGCACGGCGTCCTACTTCT
AGGCAGGCTTATGTCTAGC -> GGCAGGCTTATGTCTAGCA
AGGCAGGGCAATTTGTCCT -> GGCAGGGCAATTTGTCCTC
AGGCATTACCGCACCCTCG -> GGCATTACCGCACCCTCGC
AGGCCGGTTTTTAGTCTGA -> GGCCGGTTTTTAGTCTGAG
AGGCGAAAAGTATGGTTAG -> GGCGAAAAGTATGGTTAGC
AGGCGTGAGAATTCGCGTC -> GGCGTGAGAATTCGCGTCC
AGGCTAGCCGAGTACTGCT -> GGCTAGCCGAGTACTGCTG
AGGCTCTTATGTATAAGCA -> GGCTCTTATGTATAAGCAG
AGGCTTATGTCTAGCAACC -> GGCTTATGTCTAGCAACCA
AGGGAAACCTGCTAGTTAT -> GGGAAACCTGCTAGTTATA
AGGGAGCTACTCACGCGTG -> GGGAGCTACTCACGCGTGA
AGGGAGTATAGTATCAGGT -> GGGAGTATAGTATCAGGTT
AGGGCAATTTGTCCTCCAT -> GGGCAATTTGTCCTCCATC
AGGGGGAGATATATAAGGA -> GGGGGAGATATATAAGGAG
AGGGGTAACACCGCCGACT -> GGGGTAACACCGCCGACTG
AGGGGTAGATTGCCGTAGG -> GGGGTAGATTGCCGTAGGG
AGGGTTCGTGGTGAAGCGG -> GGGTTCGTGGTGAAGCGGT
AGGTAGAGGTTAGACGATT -> GGTAGAGGTTAGACGATTG
AGGTCATCAAATTTAGCTG -> GGTCATCAAATTTAGCTGC
AGGTCCATTGACACTCGTT -> GGTCCATTGACACTCGTTA
AGGTCCGCCGGTAGGCCGG -> GGTCCGCCGGTAGGCCGGT
AGGTGGTCGGTTAAGTGAA -> GGTGGTCGGTTAAGTGAAA
AGGTTAGACGATTGAAAGC -> GGTTAGACGATTGAAAGCA
AGGTTGCGGCGTTGCACCA -> GGTTGCGGCGTTGCACCAG
AGGTTTACTCATGTTACGC -> GGTTTACTCATGTTACGCC
AGGTTTCTTTAGCTCATGT -> GGTTTCTTTAGCTCATGTG
AGGTTTGGTCAGCGGTGGG -> GGTTTGGTCAGCGGTGGGT
AGTAAATGCTCGTCTCAAT -> GTAAATGCTCGTCTCAATT
AGTAAGTGCTGGCACGGGG -> GTAAGTGCTGGCACGGGGA
AGTACTGCTGCATAGGAAA -> GTACTGCTGCATAGGAAAG
AGTAGATATGGAGCCTAAA -> GTAGATATGGAGCCTAAAC
AGTAGCCGCATATGGGTGG -> GTAGCCGCATATGGGTGGA
AGTATAGTATCAGGTTTAC -> GTATAGTATCAGGTTTACT
AGTATCAGGTTTACTCATG -> GTATCAGGTTTACTCATGT
AGTATGGTTAGCTGCAGAG -> GTATGGTTAGCTGCAGAGT
AGTCAGCGGCGCAGAGTGC -> GTCAGCGGCGCAGAGTGCG
AGTCATGAGTTATGGACGG -> GTCATGAGTTATGGACGGG
AGTCGGCATCCGTTAGCCT -> GTCGGCATCCGTTAGCCTA
AGTCTATGGCACACGCAAT -> GTCTATGGCACACGCAATG
AGTCTGAGTAAGTGCTGGC -> GTCTGAGTAAGTGCTGGCA
AGTCTGCTCCCACCGGATC -> GTCTGCTCCCACCGGATCC
AGTGAAAGTTCTTAGCAGG -> GTGAAAGTTCTTAGCAGGA
AGTGAGAGATTTGACCACC -> GTGAGAGATTTGACCACCC
AGTGAGATCACGGAACGAT -> GTGAGATCACGGAACGATG
AGTGATCACGGGCTGTTGC -> GTGATCACGGGCTGTTGCT
AGTGCAAGTTCAATCAACG -> GTGCAAGTTCAATCAACGA
AGTGCGACTGGCGTTCATG -> GTGCGACTGGCGTTCATGG
AGTGCTGGCACGGGGATGA -> GTGCTGGCACGGGGATGAT
AGTGGACAAATCGACAATT -> GTGGACAAATCGACAATTT
AGTGGTACTTTCGTGGCTC -> GTGGTACTTTCGTGGCTCT
AGTGGTATCAACCAACCCA -> GTGGTATCAACCAACCCAT
AGTGTACGTGGGTAATTGG -> GTGTACGTGGGTAATTGGA
AGTTACAACCTCCGCGCGA -> GTTACAACCTCCGCGCGAT
AGTTATAAGACCTTATGAG -> GTTATAAGACCTTATGAGC
AGTTATGGACGGGAGGACG -> GTTATGGACGGGAGGACGT
AGTTCAATAAAAGGTTGCG -> GTTCAATAAAAGGTTGCGG
AGTTCAATCAACGAGCCAG -> GTTCAATCAACGAGCCAGG
AGTTCAATCAGACTGAAAC -> GTTCAATCAGACTGAAACG
AGTTCAATGGCTAGCTTCT -> GTTCAATGGCTAGCTTCTG
AGTTCAATTTCTCACGGAT -> GTTCAATTTCTCACGGATG
AGTTCGCGATTGCAAGCTA -> GTTCGCGATTGCAAGCTAA
AGTTCTTAGCAGGAATACG -> GTTCTTAGCAGGAATACGC
AGTTGAAGCCTTCGACCAA -> GTTGAAGCCTTCGACCAAT
AGTTGGGACCTTCCTGGCC -> GTTGGGACCTTCCTGGCCG
AGTTGGTTCGCCCATGGTC -> GTTGGTTCGCCCATGGTCA
AGTTGTGGGGAGGTGGTCG -> GTTGTGGGGAGGTGGTCGG
AGTTTCTCATTCTGTGATA -> GTTTCTCATTCTGTGATAC
AGTTTGATACCACTTTCCG -> GTTTGATACCACTTTCCGC
AGTTTGATAGCGCCAAACA -> GTTTGATAGCGCCAAACAG
AGTTTGATAGGCAGGGCAA -> GTTTGATAGGCAGGGCAAT
AGTTTGATATCATTGTGAC -> GTTTGATATCATTGTGACG
AGTTTTACAATTCGCAGAC -> GTTTTACAATTCGCAGACA
AGTTTTTCCCGCGCTTGTG -> GTTTTTCCCGCGCTTGTGT
ATAAAAGGTTGCGGCGTTG -> TAAAAGGTTGCGGCGTTGC
ATAAAGCCCCCGCGGCCCA -> TAAAGCCCCCGCGGCCCAC
ATAACAGGTCATCAAATTT -> TAACAGGTCATCAAATTTA
ATAACCTAGCTTCTCGTGC -> TAACCTAGCTTCTCGTGCT
ATAAGACCTTATGAGCGTA -> TAAGACCTTATGAGCGTAA
ATAAGCAAGGAGACAAAGT -> TAAGCAAGGAGACAAAGTG
ATAAGCAGCTAGTAGATAT -> TAAGCAGCTAGTAGATATG
ATAAGCCGATTACTCCCTC -> TAAGCCGATTACTCCCTCG
ATAAGGAGTCTATGGCACA -> TAAGGAGTCTATGGCACAC
ATAATAGTGATCACGGGCT -> TAATAGTGATCACGGGCTG
ATAATGGCATTGCAAGGCA -> TAATGGCATTGCAAGGCAG
ATAATTGGAGTGAGAGATT -> TAATTGGAGTGAGAGATTT
ATACCACTTTCCGCATAAG -> TACCACTTTCCGCATAAGC
ATACCGCGGAGGTAGAGGT -> TACCGCGGAGGTAGAGGTT
ATACGCTCACCTGTGACAC -> TACGCTCACCTGTGACACA
ATACGGAGTGGTATCAACC -> TACGGAGTGGTATCAACCA
ATACGTCGGGTGCAAGTTT -> TACGTCGGGTGCAAGTTTC
ATACGTGAATGCACGCGAC -> TACGTGAATGCACGCGACC
ATAGCCCTACGAGATGAAG -> TAGCCCTACGAGATGAAGC
ATAGCGCCAAACAGAAGCT -> TAGCGCCAAACAGAAGCTT
ATAGCGCCCTGGCACTGGA -> TAGCGCCCTGGCACTGGAC
ATAGCTGTCATCATAGGAA -> TAGCTGTCATCATAGGAAA
ATAGGAAAGAAACTAGCAT -> TAGGAAAGAAACTAGCATC
ATAGGAAAGAAAGTCAGCG -> TAGGAAAGAAAGTCAGCGG
ATAGGCAGGGCAATTTGTC -> TAGGCAGGGCAATTTGTCC
ATAGTATCAGGTTTACTCA -> TAGTATCAGGTTTACTCAT
ATAGTGATCACGGGCTGTT -> TAGTGATCACGGGCTGTTG
ATATAAGGAGTCTATGGCA -> TATAAGGAGTCTATGGCAC
ATATATAAGGAGTCTATGG -> TATATAAGGAGTCTATGGC
ATATCATTGTGACGGGTCT -> TATCATTGTGACGGGTCTA
ATATGGAGCCTAAACAATC -> TATGGAGCCTAAACAATCC
ATATGGGTGGAGGCACGGC -> TATGGGTGGAGGCACGGCG
ATATTCCTTTCGAGGCATT -> TATTCCTTTCGAGGCATTA
ATCAAATTTAGCTGCAGAG -> TCAAATTTAGCTGCAGAGT
ATCAACCAACCCATCACCT -> TCAACCAACCCATCACCTC
ATCAACGAGCCAGGCTAGC -> TCAACGAGCCAGGCTAGCC
ATCACCTCCACGAACATGG -> TCACCTCCACGAACATGGC
ATCACGGAACGATGACAAT -> TCACGGAACGATGACAATG
ATCACGGGCTGTTGCTTAG -> TCACGGGCTGTTGCTTAGC
ATCAGACTGAAACGCGTTG -> TCAGACTGAAACGCGTTGC
ATCAGCAGTCGGCATCCGT -> TCAGCAGTCGGCATCCGTT
ATCAGGTTTACTCATGTTA -> TCAGGTTTACTCATGTTAC
ATCAGTAAATGCTCGTCTC -> TCAGTAAATGCTCGTCTCA
ATCATAGGAAAGAAACTAG -> TCATAGGAAAGAAACTAGC
ATCATTGTGACGGGTCTAG -> TCATTGTGACGGGTCTAGA
ATCCAGTTACAACCTCCGC -> TCCAGTTACAACCTCCGCG
ATCCGCCAAGGTCCGCCGG -> TCCGCCAAGGTCCGCCGGT
ATCCGCTCTAGGAAAACTT -> TCCGCTCTAGGAAAACTTT
ATCCGTTAGCCTAAGTCAT -> TCCGTTAGCCTAAGTCATG
ATCCGTTTGAAAGGGGGAG -> TCCGTTTGAAAGGGGGAGA
ATCCTAACTATTGACAAAT -> TCCTAACTATTGACAAATT
ATCCTGGTATACGTCGGGT -> TCCTGGTATACGTCGGGTG
ATCGACAATTTTCGGACGG -> TCGACAATTTTCGGACGGA
ATCGCGCTCGAGTCTGCTC -> TCGCGCTCGAGTCTGCTCC
ATCGGCGGGCGATGCTCCT -> TCGGCGGGCGATGCTCCTT
ATCGTGGATGTGGATGTTT -> TCGTGGATGTGGATGTTTC
ATCGTTCACCATTCATACG -> TCGTTCACCATTCATACGT
ATCTACTGGCTACTAAAAA -> TCTACTGGCTACTAAAAAT
ATCTTAGCTGAAATCGCGC -> TCTTAGCTGAAATCGCGCT
ATGAAGCGGGCTCCGCTCG -> TGAAGCGGGCTCCGCTCGC
ATGACAATGTCACTCATCG -> TGACAATGTCACTCATCGT
ATGAGCGTAACGCAGGGAG -> TGAGCGTAACGCAGGGAGC
ATGAGGCAAAGACCCGGTT -> TGAGGCAAAGACCCGGTTG
ATGAGTTATGGACGGGAGG -> TGAGTTATGGACGGGAGGA
ATGATAATTGGAGTGAGAG -> TGATAATTGGAGTGAGAGA
ATGCACGCGACCTAAGATC -> TGCACGCGACCTAAGATCC
ATGCGAGTTGTGGGGAGGT -> TGCGAGTTGTGGGGAGGTG
ATGCGTTGCACCAGTTTGA -> TGCGTTGCACCAGTTTGAT
ATGCTCCTTCGCGTACATA -> TGCTCCTTCGCGTACATAA
ATGCTCGTCTCAATTCCTC -> TGCTCGTCTCAATTCCTCA
ATGGACGGGAGGACGTGAA -> TGGACGGGAGGACGTGAAC
ATGGAGCCTAAACAATCCG -> TGGAGCCTAAACAATCCGC
ATGGCACACGCAATGAGGC -> TGGCACACGCAATGAGGCA
ATGGCATTGCAAGGCAGGC -> TGGCATTGCAAGGCAGGCT
ATGGCTAGCTTCTGCGTTG -> TGGCTAGCTTCTGCGTTGC
ATGGGAACAAGAAGAACTG -> TGGGAACAAGAAGAACTGA
ATGGGCACCTTCCGTACCG -> TGGGCACCTTCCGTACCGA
ATGGGTGGAGGCACGGCGT -> TGGGTGGAGGCACGGCGTC
ATGGTAAGATTCTGTTATG -> TGGTAAGATTCTGTTATGT
ATGGTCAGCATAACAGGTC -> TGGTCAGCATAACAGGTCA
ATGGTGTTACTAGACTCCG -> TGGTGTTACTAGACTCCGA
ATGGTTAGCTGCAGAGTTC -> TGGTTAGCTGCAGAGTTCA
ATGTATAAGCAGCTAGTAG -> TGTATAAGCAGCTAGTAGA
ATGTCACTCATCGTGGATG -> TGTCACTCATCGTGGATGT
ATGTCTAGCAACCAAGAAA -> TGTCTAGCAACCAAGAAAA
ATGTGAACATAAGCCGATT -> TGTGAACATAAGCCGATTA
ATGTGGATGTTTCGATAGC -> TGTGGATGTTTCGATAGCG
ATGTGGCGCTGAGTTGAAG -> TGTGGCGCTGAGTTGAAGC
ATGTGGGTACTAGTTTTAC -> TGTGGGTACTAGTTTTACA
ATGTTACGCCTTCTATAAA -> TGTTACGCCTTCTATAAAG
ATGTTTCGATAGCGCCCTG -> TGTTTCGATAGCGCCCTGG
ATTAAGAGACAGGTTTGGT -> TTAAGAGACAGGTTTGGTC
ATTACCGCACCCTCGCGGT -> TTACCGCACCCTCGCGGTG
ATTACTCCCTCGGGTAACC -> TTACTCCCTCGGGTAACCG
ATTAGCTGCAGAGTTCAAT -> TTAGCTGCAGAGTTCAATA
ATTAGGAGTAGCCGCATAT -> TTAGGAGTAGCCGCATATG
ATTAGGCGAAAAGTATGGT -> TTAGGCGAAAAGTATGGTT
ATTCATACGTGAATGCACG -> TTCATACGTGAATGCACGC
ATTCCTCAAGTGGTACTTT -> TTCCTCAAGTGGTACTTTC
ATTCCTTTCGAGGCATTAC -> TTCCTTTCGAGGCATTACC
ATTCGCAGACACAGCGTCG -> TTCGCAGACACAGCGTCGT
ATTCGCGTCCATGCGAGTT -> TTCGCGTCCATGCGAGTTG
ATTCTGTGATACCGCGGAG -> TTCTGTGATACCGCGGAGG
ATTCTGTTATGTGGGTACT -> TTCTGTTATGTGGGTACTA
ATTGAAAGCAGTGAGATCA -> TTGAAAGCAGTGAGATCAC
ATTGACAAATTGTCTGAAC -> TTGACAAATTGTCTGAACG
ATTGACACTCGTTAGGGAA -> TTGACACTCGTTAGGGAAA
ATTGCAAGCTAAACCCATA -> TTGCAAGCTAAACCCATAT
ATTGCAAGGCAGGCTTATG -> TTGCAAGGCAGGCTTATGT
ATTGCCGTAGGGAGTATAG -> TTGCCGTAGGGAGTATAGT
ATTGCGTCCAAATAGCTGT -> TTGCGTCCAAATAGCTGTC
ATTGGACTCTACAACGATC -> TTGGACTCTACAACGATCG
ATTGGAGTGAGAGATTTGA -> TTGGAGTGAGAGATTTGAC
ATTGTCTGAACGACCGGCG -> TTGTCTGAACGACCGGCGT
ATTGTGACGGGTCTAGACG -> TTGTGACGGGTCTAGACGG
ATTTAGCTGCAGAGTTCAA -> TTTAGCTGCAGAGTTCAAT
ATTTCCGAATAATAGTGAT -> TTTCCGAATAATAGTGATC
ATTTCTCACGGATGCGTTG -> TTTCTCACGGATGCGTTGC
ATTTGACCACCCAACAGGC -> TTTGACCACCCAACAGGCG
ATTTGTCCTCCATCCTAAC -> TTTGTCCTCCATCCTAACT
ATTTTCGGACGGATTAGGC -> TTTTCGGACGGATTAGGCG
ATTTTTTTACGCTCGTTTG -> TTTTTTTACGCTCGTTTGT
CAAAACGTTAGAAGTTGGG -> AAAACGTTAGAAGTTGGGA
CAAACAGAAGCTTATCCAG -> AAACAGAAGCTTATCCAGT
CAAAGACCCGGTTGGGATG -> AAAGACCCGGTTGGGATGG
CAAAGTGGACAAATCGACA -> AAAGTGGACAAATCGACAA
CAAATAGCCCTACGAGATG -> AAATAGCCCTACGAGATGA
CAAATAGCTGTCATCATAG -> AAATAGCTGTCATCATAGG
CAAATCGACAATTTTCGGA -> AAATCGACAATTTTCGGAC
CAAATTGTCTGAACGACCG -> AAATTGTCTGAACGACCGG
CAAATTTAGCTGCAGAGTT -> AAATTTAGCTGCAGAGTTC
CAACAGGCGTGAGAATTCG -> AACAGGCGTGAGAATTCGC
CAACCAACCCATCACCTCC -> AACCAACCCATCACCTCCA
CAACCAAGAAAACCTGCCA -> AACCAAGAAAACCTGCCAC
CAACCCATCACCTCCACGA -> AACCCATCACCTCCACGAA
CAACCTCCGCGCGATGTGA -> AACCTCCGCGCGATGTGAA
CAACGAGCCAGGCTAGCCG -> AACGAGCCAGGCTAGCCGA
CAACGATCGTTCACCATTC -> AACGATCGTTCACCATTCA
CAACGATTTCCGAATAATA -> AACGATTTCCGAATAATAG
CAAGAAAACCTGCCACTAA -> AAGAAAACCTGCCACTAAG
CAAGAAGAACTGAAAAGTT -> AAGAAGAACTGAAAAGTTT
CAAGCTAAACCCATATTCC -> AAGCTAAACCCATATTCCT
CAAGGAGACAAAGTGGACA -> AAGGAGACAAAGTGGACAA
CAAGGCAGGCTTATGTCTA -> AAGGCAGGCTTATGTCTAG
CAAGGCTCTTATGTATAAG -> AAGGCTCTTATGTATAAGC
CAAGGTCCGCCGGTAGGCC -> AAGGTCCGCCGGTAGGCCG
CAAGTGGTACTTTCGTGGC -> AAGTGGTACTTTCGTGGCT
CAAGTTCAATCAACGAGCC -> AAGTTCAATCAACGAGCCA
CAAGTTTCTCATTCTGTGA -> AAGTTTCTCATTCTGTGAT
CAATAAAAGGTTGCGGCGT -> AATAAAAGGTTGCGGCGTT
CAATAACCTAGCTTCTCGT -> AATAACCTAGCTTCTCGTG
CAATCAACGAGCCAGGCTA -> AATCAACGAGCCAGGCTAG
CAATCAGACTGAAACGCGT -> AATCAGACTGAAACGCGTT
CAATCCGCTCTAGGAAAAC -> AATCCGCTCTAGGAAAACT
CAATGAGGCAAAGACCCGG -> AATGAGGCAAAGACCCGGT
CAATGGCTAGCTTCTGCGT -> AATGGCTAGCTTCTGCGTT
CAATGTCACTCATCGTGGA -> AATGTCACTCATCGTGGAT
CAATTCCTCAAGTGGTACT -> AATTCCTCAAGTGGTACTT
CAATTCGCAGACACAGCGT -> AATTCGCAGACACAGCGTC
CAATTTCTCACGGATGCGT -> AATTTCTCACGGATGCGTT
CAATTTGTCCTCCATCCTA -> AATTTGTCCTCCATCCTAA
CAATTTTCGGACGGATTAG -> AATTTTCGGACGGATTAGG
CACAAGGCTCTTATGTATA -> ACAAGGCTCTTATGTATAA
CACACCTGTTCAACGATTT -> ACACCTGTTCAACGATTTC
CACACGCAATGAGGCAAAG -> ACACGCAATGAGGCAAAGA
CACAGCGTCGTGCTCCACG -> ACAGCGTCGTGCTCCACGG
CACAGTTGGTTCGCCCATG -> ACAGTTGGTTCGCCCATGG
CACCAGTTTGATACCACTT -> ACCAGTTTGATACCACTTT
CACCAGTTTGATAGCGCCA -> ACCAGTTTGATAGCGCCAA
CACCAGTTTGATAGGCAGG -> ACCAGTTTGATAGGCAGGG
CACCAGTTTGATATCATTG -> ACCAGTTTGATATCATTGT
CACCATTCATACGTGAATG -> ACCATTCATACGTGAATGC
CACCCAACAGGCGTGAGAA -> ACCCAACAGGCGTGAGAAT
CACCCTCGCGGTGTGAAAG -> ACCCTCGCGGTGTGAAAGG
CACCGCCGACTGCACACCT -> ACCGCCGACTGCACACCTG
CACCGGATCCTGGTATACG -> ACCGGATCCTGGTATACGT
CACCTCCACGAACATGGCA -> ACCTCCACGAACATGGCAA
CACCTGTGACACAGTTGGT -> ACCTGTGACACAGTTGGTT
CACCTGTTCAACGATTTCC -> ACCTGTTCAACGATTTCCG
CACCTTCCGTACCGACCAG -> ACCTTCCGTACCGACCAGG
CACGAACATGGCAACTCAG -> ACGAACATGGCAACTCAGA
CACGCAATGAGGCAAAGAC -> ACGCAATGAGGCAAAGACC
CACGCGACCTAAGATCCGC -> ACGCGACCTAAGATCCGCC
CACGCGTGAAATTAGCTGC -> ACGCGTGAAATTAGCTGCA
CACGGAACGATGACAATGT -> ACGGAACGATGACAATGTC
CACGGATGCGTTGCACCAG -> ACGGATGCGTTGCACCAGT
CACGGCGTCCTACTTCTAC -> ACGGCGTCCTACTTCTACA
CACGGGCTGTTGCTTAGCT -> ACGGGCTGTTGCTTAGCTG
CACGGGGATGATAATTGGA -> ACGGGGATGATAATTGGAG
CACGGGGCCATTTTTTTAC -> ACGGGGCCATTTTTTTACG
CACTAAGCTCCAAATAGCC -> ACTAAGCTCCAAATAGCCC
CACTCATCGTGGATGTGGA -> ACTCATCGTGGATGTGGAT
CACTCGTTAGGGAAACCTG -> ACTCGTTAGGGAAACCTGC
CACTGGACCGTATCGGCGG -> ACTGGACCGTATCGGCGGG
CACTTAGCGCTGGCCGATT -> ACTTAGCGCTGGCCGATTG
CACTTTCCGCATAAGCAAG -> ACTTTCCGCATAAGCAAGG
CAGAAACCGAGTTCGCGAT -> AGAAACCGAGTTCGCGATT
CAGAAGCTTATCCAGTTAC -> AGAAGCTTATCCAGTTACA
CAGACACAGCGTCGTGCTC -> AGACACAGCGTCGTGCTCC
CAGACTGAAACGCGTTGCA -> AGACTGAAACGCGTTGCAC
CAGAGAAACCGATCTTAGC -> AGAGAAACCGATCTTAGCT
CAGAGTGCGACTGGCGTTC -> AGAGTGCGACTGGCGTTCA
CAGAGTTCAATAAAAGGTT -> AGAGTTCAATAAAAGGTTG
CAGAGTTCAATCAGACTGA -> AGAGTTCAATCAGACTGAA
CAGAGTTCAATGGCTAGCT -> AGAGTTCAATGGCTAGCTT
CAGAGTTCAATTTCTCACG -> AGAGTTCAATTTCTCACGG
CAGCAGTCGGCATCCGTTA -> AGCAGTCGGCATCCGTTAG
CAGCATAACAGGTCATCAA -> AGCATAACAGGTCATCAAA
CAGCCTGGACAGAGAAACC -> AGCCTGGACAGAGAAACCG
CAGCGGCGCAGAGTGCGAC -> AGCGGCGCAGAGTGCGACT
CAGCGGTGGGTCCTCTACC -> AGCGGTGGGTCCTCTACCT
CAGCGTCGTGCTCCACGGG -> AGCGTCGTGCTCCACGGGG
CAGCTAGTAGATATGGAGC -> AGCTAGTAGATATGGAGCC
CAGGAATACGCTCACCTGT -> AGGAATACGCTCACCTGTG
CAGGCGTGAGAATTCGCGT -> AGGCGTGAGAATTCGCGTC
CAGGCTAGCCGAGTACTGC -> AGGCTAGCCGAGTACTGCT
CAGGCTTATGTCTAGCAAC -> AGGCTTATGTCTAGCAACC
CAGGGAGCTACTCACGCGT -> AGGGAGCTACTCACGCGTG
CAGGGCAATTTGTCCTCCA -> AGGGCAATTTGTCCTCCAT
CAGGGGTAACACCGCCGAC -> AGGGGTAACACCGCCGACT
CAGGTCATCAAATTTAGCT -> AGGTCATCAAATTTAGCTG
CAGGTTTACTCATGTTACG -> AGGTTTACTCATGTTACGC
CAGGTTTGGTCAGCGGTGG -> AGGTTTGGTCAGCGGTGGG
CAGTAAATGCTCGTCTCAA -> AGTAAATGCTCGTCTCAAT
CAGTCGGCATCCGTTAGCC -> AGTCGGCATCCGTTAGCCT
CAGTGAGATCACGGAACGA -> AGTGAGATCACGGAACGAT
CAGTTACAACCTCCGCGCG -> AGTTACAACCTCCGCGCGA
CAGTTGGTTCGCCCATGGT -> AGTTGGTTCGCCCATGGTC
CAGTTTGATACCACTTTCC -> AGTTTGATACCACTTTCCG
CAGTTTGATAGCGCCAAAC -> AGTTTGATAGCGCCAAACA
CAGTTTGATAGGCAGGGCA -> AGTTTGATAGGCAGGGCAA
CAGTTTGATATCATTGTGA -> AGTTTGATATCATTGTGAC
CATAACAGGTCATCAAATT -> ATAACAGGTCATCAAATTT
CATAAGCAAGGAGACAAAG -> ATAAGCAAGGAGACAAAGT
CATAAGCCGATTACTCCCT -> ATAAGCCGATTACTCCCTC
CATAATGGCATTGCAAGGC -> ATAATGGCATTGCAAGGCA
CATACGTGAATGCACGCGA -> ATACGTGAATGCACGCGAC
CATAGGAAAGAAACTAGCA -> ATAGGAAAGAAACTAGCAT
CATAGGAAAGAAAGTCAGC -> ATAGGAAAGAAAGTCAGCG
CATATGGGTGGAGGCACGG -> ATATGGGTGGAGGCACGGC
CATATTCCTTTCGAGGCAT -> ATATTCCTTTCGAGGCATT
CATCAAATTTAGCTGCAGA -> ATCAAATTTAGCTGCAGAG
CATCACCTCCACGAACATG -> ATCACCTCCACGAACATGG
CATCATAGGAAAGAAACTA -> ATCATAGGAAAGAAACTAG
CATCCGTTAGCCTAAGTCA -> ATCCGTTAGCCTAAGTCAT
CATCCTAACTATTGACAAA -> ATCCTAACTATTGACAAAT
CATCGTGGATGTGGATGTT -> ATCGTGGATGTGGATGTTT
CATCTACTGGCTACTAAAA -> ATCTACTGGCTACTAAAAA
CATGAGTTATGGACGGGAG -> ATGAGTTATGGACGGGAGG
CATGCGAGTTGTGGGGAGG -> ATGCGAGTTGTGGGGAGGT
CATGGTCAGCATAACAGGT -> ATGGTCAGCATAACAGGTC
CATGGTGTTACTAGACTCC -> ATGGTGTTACTAGACTCCG
CATGTGGCGCTGAGTTGAA -> ATGTGGCGCTGAGTTGAAG
CATGTTACGCCTTCTATAA -> ATGTTACGCCTTCTATAAA
CATTACCGCACCCTCGCGG -> ATTACCGCACCCTCGCGGT
CATTAGGAGTAGCCGCATA -> ATTAGGAGTAGCCGCATAT
CATTCATACGTGAATGCAC -> ATTCATACGTGAATGCACG
CATTCTGTGATACCGCGGA -> ATTCTGTGATACCGCGGAG
CATTGACACTCGTTAGGGA -> ATTGACACTCGTTAGGGAA
CATTGCAAGGCAGGCTTAT -> ATTGCAAGGCAGGCTTATG
CATTGTGACGGGTCTAGAC -> ATTGTGACGGGTCTAGACG
CATTTTTTTACGCTCGTTT -> ATTTTTTTACGCTCGTTTG
CCAAACAGAAGCTTATCCA -> CAAACAGAAGCTTATCCAG
CCAAATAGCCCTACGAGAT -> CAAATAGCCCTACGAGATG
CCAAATAGCTGTCATCATA -> CAAATAGCTGTCATCATAG
CCAACAGGCGTGAGAATTC -> CAACAGGCGTGAGAATTCG
CCAACCCATCACCTCCACG -> CAACCCATCACCTCCACGA
CCAAGAAAACCTGCCACTA -> CAAGAAAACCTGCCACTAA
CCAAGGTCCGCCGGTAGGC -> CAAGGTCCGCCGGTAGGCC
CCAATAACCTAGCTTCTCG -> CAATAACCTAGCTTCTCGT
CCACAAGGCTCTTATGTAT -> CACAAGGCTCTTATGTATA
CCACCCAACAGGCGTGAGA -> CACCCAACAGGCGTGAGAA
CCACCGGATCCTGGTATAC -> CACCGGATCCTGGTATACG
CCACGAACATGGCAACTCA -> CACGAACATGGCAACTCAG
CCACGGGGCCATTTTTTTA -> CACGGGGCCATTTTTTTAC
CCACTAAGCTCCAAATAGC -> CACTAAGCTCCAAATAGCC
CCACTTAGCGCTGGCCGAT -> CACTTAGCGCTGGCCGATT
CCACTTTCCGCATAAGCAA -> CACTTTCCGCATAAGCAAG
CCAGGCTAGCCGAGTACTG -> CAGGCTAGCCGAGTACTGC
CCAGGGGTAACACCGCCGA -> CAGGGGTAACACCGCCGAC
CCAGTTACAACCTCCGCGC -> CAGTTACAACCTCCGCGCG
CCAGTTTGATACCACTTTC -> CAGTTTGATACCACTTTCC
CCAGTTTGATAGCGCCAAA -> CAGTTTGATAGCGCCAAAC
CCAGTTTGATAGGCAGGGC -> CAGTTTGATAGGCAGGGCA
CCAGTTTGATATCATTGTG -> CAGTTTGATATCATTGTGA
CCATATTCCTTTCGAGGCA -> CATATTCCTTTCGAGGCAT
CCATCACCTCCACGAACAT -> CATCACCTCCACGAACATG
CCATCCTAACTATTGACAA -> CATCCTAACTATTGACAAA
CCATGCGAGTTGTGGGGAG -> CATGCGAGTTGTGGGGAGG
CCATGGTCAGCATAACAGG -> CATGGTCAGCATAACAGGT
CCATTCATACGTGAATGCA -> CATTCATACGTGAATGCAC
CCATTGACACTCGTTAGGG -> CATTGACACTCGTTAGGGA
CCATTTTTTTACGCTCGTT -> CATTTTTTTACGCTCGTTT
CCCAACAGGCGTGAGAATT -> CCAACAGGCGTGAGAATTC
CCCACCGGATCCTGGTATA -> CCACCGGATCCTGGTATAC
CCCACTTAGCGCTGGCCGA -> CCACTTAGCGCTGGCCGAT
CCCATATTCCTTTCGAGGC -> CCATATTCCTTTCGAGGCA
CCCATCACCTCCACGAACA -> CCATCACCTCCACGAACAT
CCCATGGTCAGCATAACAG -> CCATGGTCAGCATAACAGG
CCCCCGCGGCCCACTTAGC -> CCCCGCGGCCCACTTAGCG
CCCCGCGGCCCACTTAGCG -> CCCGCGGCCCACTTAGCGC
CCCGCGCTTGTGTATGGGC -> CCGCGCTTGTGTATGGGCA
CCCGCGGCCCACTTAGCGC -> CCGCGGCCCACTTAGCGCT
CCCGGTTGGGATGGGAACA -> CCGGTTGGGATGGGAACAA
CCCTACGAGATGAAGCGGG -> CCTACGAGATGAAGCGGGC
CCCTCATTAGGAGTAGCCG -> CCTCATTAGGAGTAGCCGC
CCCTCGCGGTGTGAAAGGG -> CCTCGCGGTGTGAAAGGGG
CCCTCGGGTAACCGGGTAG -> CCTCGGGTAACCGGGTAGT
CCCTCTGTTTTCGGGCTAA -> CCTCTGTTTTCGGGCTAAC
CCCTGGCACTGGACCGTAT -> CCTGGCACTGGACCGTATC
CCGAATAATAGTGATCACG -> CGAATAATAGTGATCACGG
CCGACCAGGGGTAACACCG -> CGACCAGGGGTAACACCGC
CCGACTGCACACCTGTTCA -> CGACTGCACACCTGTTCAA
CCGAGTACTGCTGCATAGG -> CGAGTACTGCTGCATAGGA
CCGAGTTCGCGATTGCAAG -> CGAGTTCGCGATTGCAAGC
CCGATCAGTAAATGCTCGT -> CGATCAGTAAATGCTCGTC
CCGATCTTAGCTGAAATCG -> CGATCTTAGCTGAAATCGC
CCGATTACTCCCTCGGGTA -> CGATTACTCCCTCGGGTAA
CCGATTGCGTCCAAATAGC -> CGATTGCGTCCAAATAGCT
CCGCACCCTCGCGGTGTGA -> CGCACCCTCGCGGTGTGAA
CCGCATAAGCAAGGAGACA -> CGCATAAGCAAGGAGACAA
CCGCATATGGGTGGAGGCA -> CGCATATGGGTGGAGGCAC
CCGCCAAGGTCCGCCGGTA -> CGCCAAGGTCCGCCGGTAG
CCGCCGACTGCACACCTGT -> CGCCGACTGCACACCTGTT
CCGCCGGTAGGCCGGTTTT -> CGCCGGTAGGCCGGTTTTT
CCGCGCGATGTGAACATAA -> CGCGCGATGTGAACATAAG
CCGCGCTTGTGTATGGGCA -> CGCGCTTGTGTATGGGCAC
CCGCGGAGGTAGAGGTTAG -> CGCGGAGGTAGAGGTTAGA
CCGCGGCCCACTTAGCGCT -> CGCGGCCCACTTAGCGCTG
CCGCTCGCCCTCTGTTTTC -> CGCTCGCCCTCTGTTTTCG
CCGCTCTAGGAAAACTTTA -> CGCTCTAGGAAAACTTTAA
CCGGATCCTGGTATACGTC -> CGGATCCTGGTATACGTCG
CCGGCGTAGGGTTCGTGGT -> CGGCGTAGGGTTCGTGGTG
CCGGGTAGTGCAAGTTCAA -> CGGGTAGTGCAAGTTCAAT
CCGGTAGGCCGGTTTTTAG -> CGGTAGGCCGGTTTTTAGT
CCGGTTGGGATGGGAACAA -> CGGTTGGGATGGGAACAAG
CCGGTTTTTAGTCTGAGTA -> CGGTTTTTAGTCTGAGTAA
CCGTACCGACCAGGGGTAA -> CGTACCGACCAGGGGTAAC
CCGTAGGGAGTATAGTATC -> CGTAGGGAGTATAGTATCA
CCGTATCGGCGGGCGATGC -> CGTATCGGCGGGCGATGCT
CCGTGATACGGAGTGGTAT -> CGTGATACGGAGTGGTATC
CCGTTAGCCTAAGTCATGA -> CGTTAGCCTAAGTCATGAG
CCGTTTGAAAGGGGGAGAT -> CGTTTGAAAGGGGGAGATA
CCTAAACAATCCGCTCTAG -> CTAAACAATCCGCTCTAGG
CCTAACTATTGACAAATTG -> CTAACTATTGACAAATTGT
CCTAAGATCCGCCAAGGTC -> CTAAGATCCGCCAAGGTCC
CCTAAGTCATGAGTTATGG -> CTAAGTCATGAGTTATGGA
CCTACGAGATGAAGCGGGC -> CTACGAGATGAAGCGGGCT
CCTACTTCTACAAAACGTT -> CTACTTCTACAAAACGTTA
CCTAGCTTCTCGTGCTACA -> CTAGCTTCTCGTGCTACAG
CCTCAAGTGGTACTTTCGT -> CTCAAGTGGTACTTTCGTG
CCTCAGCCTGGACAGAGAA -> CTCAGCCTGGACAGAGAAA
CCTCATTAGGAGTAGCCGC -> CTCATTAGGAGTAGCCGCA
CCTCCACGAACATGGCAAC -> CTCCACGAACATGGCAACT
CCTCCATCCTAACTATTGA -> CTCCATCCTAACTATTGAC
CCTCCGCGCGATGTGAACA -> CTCCGCGCGATGTGAACAT
CCTCGCGGTGTGAAAGGGG -> CTCGCGGTGTGAAAGGGGT
CCTCGGGTAACCGGGTAGT -> CTCGGGTAACCGGGTAGTG
CCTCTACCTCAGCCTGGAC -> CTCTACCTCAGCCTGGACA
CCTCTGTTTTCGGGCTAAC -> CTCTGTTTTCGGGCTAACG
CCTGCCACTAAGCTCCAAA -> CTGCCACTAAGCTCCAAAT
CCTGCTAGTTATAAGACCT -> CTGCTAGTTATAAGACCTT
CCTGGACAGAGAAACCGAT -> CTGGACAGAGAAACCGATC
CCTGGCACTGGACCGTATC -> CTGGCACTGGACCGTATCG
CCTGGCCGTGATACGGAGT -> CTGGCCGTGATACGGAGTG
CCTGGTATACGTCGGGTGC -> CTGGTATACGTCGGGTGCA
CCTGTGACACAGTTGGTTC -> CTGTGACACAGTTGGTTCG
CCTGTTCAACGATTTCCGA -> CTGTTCAACGATTTCCGAA
CCTTATGAGCGTAACGCAG -> CTTATGAGCGTAACGCAGG
CCTTCCGTACCGACCAGGG -> CTTCCGTACCGACCAGGGG
CCTTCCTGGCCGTGATACG -> CTTCCTGGCCGTGATACGG
CCTTCGACCAATAACCTAG -> CTTCGACCAATAACCTAGC
CCTTCGCGTACATAATGGC -> CTTCGCGTACATAATGGCA
CCTTCTATAAAGCCCCCGC -> CTTCTATAAAGCCCCCGCG
CCTTTCGAGGCATTACCGC -> CTTTCGAGGCATTACCGCA
CGAAAAGTATGGTTAGCTG -> GAAAAGTATGGTTAGCTGC
CGAACATGGCAACTCAGAA -> GAACATGGCAACTCAGAAT
CGAATAATAGTGATCACGG -> GAATAATAGTGATCACGGG
CGACAATTTTCGGACGGAT -> GACAATTTTCGGACGGATT
CGACCAATAACCTAGCTTC -> GACCAATAACCTAGCTTCT
CGACCAGGGGTAACACCGC -> GACCAGGGGTAACACCGCC
CGACCGGCGTAGGGTTCGT -> GACCGGCGTAGGGTTCGTG
CGACCTAAGATCCGCCAAG -> GACCTAAGATCCGCCAAGG
CGACTGCACACCTGTTCAA -> GACTGCACACCTGTTCAAC
CGACTGGCGTTCATGGTGT -> GACTGGCGTTCATGGTGTT
CGAGATGAAGCGGGCTCCG -> GAGATGAAGCGGGCTCCGC
CGAGCCAGGCTAGCCGAGT -> GAGCCAGGCTAGCCGAGTA
CGAGGCATTACCGCACCCT -> GAGGCATTACCGCACCCTC
CGAGTACTGCTGCATAGGA -> GAGTACTGCTGCATAGGAA
CGAGTCTGCTCCCACCGGA -> GAGTCTGCTCCCACCGGAT
CGAGTTCGCGATTGCAAGC -> GAGTTCGCGATTGCAAGCT
CGAGTTGTGGGGAGGTGGT -> GAGTTGTGGGGAGGTGGTC
CGATAGCGCCCTGGCACTG -> GATAGCGCCCTGGCACTGG
CGATCAGTAAATGCTCGTC -> GATCAGTAAATGCTCGTCT
CGATCGTTCACCATTCATA -> GATCGTTCACCATTCATAC
CGATCTTAGCTGAAATCGC -> GATCTTAGCTGAAATCGCG
CGATGACAATGTCACTCAT -> GATGACAATGTCACTCATC
CGATGCTCCTTCGCGTACA -> GATGCTCCTTCGCGTACAT
CGATGTGAACATAAGCCGA -> GATGTGAACATAAGCCGAT
CGATTACTCCCTCGGGTAA -> GATTACTCCCTCGGGTAAC
CGATTGAAAGCAGTGAGAT -> GATTGAAAGCAGTGAGATC
CGATTGCAAGCTAAACCCA -> GATTGCAAGCTAAACCCAT
CGATTGCGTCCAAATAGCT -> GATTGCGTCCAAATAGCTG
CGATTTCCGAATAATAGTG -> GATTTCCGAATAATAGTGA
CGCAATGAGGCAAAGACCC -> GCAATGAGGCAAAGACCCG
CGCACCCTCGCGGTGTGAA -> GCACCCTCGCGGTGTGAAA
CGCAGACACAGCGTCGTGC -> GCAGACACAGCGTCGTGCT
CGCAGAGTGCGACTGGCGT -> GCAGAGTGCGACTGGCGTT
CGCAGGGAGCTACTCACGC -> GCAGGGAGCTACTCACGCG
CGCATAAGCAAGGAGACAA -> GCATAAGCAAGGAGACAAA
CGCATATGGGTGGAGGCAC -> GCATATGGGTGGAGGCACG
CGCCAAACAGAAGCTTATC -> GCCAAACAGAAGCTTATCC
CGCCAAGGTCCGCCGGTAG -> GCCAAGGTCCGCCGGTAGG
CGCCCATGGTCAGCATAAC -> GCCCATGGTCAGCATAACA
CGCCCTCTGTTTTCGGGCT -> GCCCTCTGTTTTCGGGCTA
CGCCCTGGCACTGGACCGT -> GCCCTGGCACTGGACCGTA
CGCCGACTGCACACCTGTT -> GCCGACTGCACACCTGTTC
CGCCGGTAGGCCGGTTTTT -> GCCGGTAGGCCGGTTTTTA
CGCCTTCTATAAAGCCCCC -> GCCTTCTATAAAGCCCCCG
CGCGACCTAAGATCCGCCA -> GCGACCTAAGATCCGCCAA
CGCGATGTGAACATAAGCC -> GCGATGTGAACATAAGCCG
CGCGATTGCAAGCTAAACC -> GCGATTGCAAGCTAAACCC
CGCGCGATGTGAACATAAG -> GCGCGATGTGAACATAAGC
CGCGCTCGAGTCTGCTCCC -> GCGCTCGAGTCTGCTCCCA
CGCGCTTGTGTATGGGCAC -> GCGCTTGTGTATGGGCACC
CGCGGAGGTAGAGGTTAGA -> GCGGAGGTAGAGGTTAGAC
CGCGGCCCACTTAGCGCTG -> GCGGCCCACTTAGCGCTGG
CGCGGTGTGAAAGGGGTAG -> GCGGTGTGAAAGGGGTAGA
CGCGTACATAATGGCATTG -> GCGTACATAATGGCATTGC
CGCGTCCATGCGAGTTGTG -> GCGTCCATGCGAGTTGTGG
CGCGTGAAATTAGCTGCAG -> GCGTGAAATTAGCTGCAGA
CGCGTTGCACCAGTTTGAT -> GCGTTGCACCAGTTTGATA
CGCTCACCTGTGACACAGT -> GCTCACCTGTGACACAGTT
CGCTCGAGTCTGCTCCCAC -> GCTCGAGTCTGCTCCCACC
CGCTCGCCCTCTGTTTTCG -> GCTCGCCCTCTGTTTTCGG
CGCTCGTTTGTTCCCTCAT -> GCTCGTTTGTTCCCTCATT
CGCTCTAGGAAAACTTTAA -> GCTCTAGGAAAACTTTAAG
CGCTGAGTTGAAGCCTTCG -> GCTGAGTTGAAGCCTTCGA
CGCTGGCCGATTGCGTCCA -> GCTGGCCGATTGCGTCCAA
CGCTTGTGTATGGGCACCT -> GCTTGTGTATGGGCACCTT
CGGAACGATGACAATGTCA -> GGAACGATGACAATGTCAC
CGGAAGGTTTCTTTAGCTC -> GGAAGGTTTCTTTAGCTCA
CGGACGGATTAGGCGAAAA -> GGACGGATTAGGCGAAAAG
CGGAGGTAGAGGTTAGACG -> GGAGGTAGAGGTTAGACGA
CGGAGTGGTATCAACCAAC -> GGAGTGGTATCAACCAACC
CGGATCCTGGTATACGTCG -> GGATCCTGGTATACGTCGG
CGGATGCGTTGCACCAGTT -> GGATGCGTTGCACCAGTTT
CGGATTAGGCGAAAAGTAT -> GGATTAGGCGAAAAGTATG
CGGCATCCGTTAGCCTAAG -> GGCATCCGTTAGCCTAAGT
CGGCCCACTTAGCGCTGGC -> GGCCCACTTAGCGCTGGCC
CGGCGCAGAGTGCGACTGG -> GGCGCAGAGTGCGACTGGC
CGGCGGGCGATGCTCCTTC -> GGCGGGCGATGCTCCTTCG
CGGCGTAGGGTTCGTGGTG -> GGCGTAGGGTTCGTGGTGA
CGGCGTCCTACTTCTACAA -> GGCGTCCTACTTCTACAAA
CGGCGTTGCACCAGTTTGA -> GGCGTTGCACCAGTTTGAT
CGGGAGGACGTGAACCACA -> GGGAGGACGTGAACCACAA
CGGGCGATGCTCCTTCGCG -> GGGCGATGCTCCTTCGCGT
CGGGCTAACGGAAGGTTTC -> GGGCTAACGGAAGGTTTCT
CGGGCTCCGCTCGCCCTCT -> GGGCTCCGCTCGCCCTCTG
CGGGCTGTTGCTTAGCTGC -> GGGCTGTTGCTTAGCTGCA
CGGGGATGATAATTGGAGT -> GGGGATGATAATTGGAGTG
CGGGGCCATTTTTTTACGC -> GGGGCCATTTTTTTACGCT
CGGGTAACCGGGTAGTGCA -> GGGTAACCGGGTAGTGCAA
CGGGTAGTGCAAGTTCAAT -> GGGTAGTGCAAGTTCAATC
CGGGTCTAGACGGTATCAG -> GGGTCTAGACGGTATCAGC
CGGGTGCAAGTTTCTCATT -> GGGTGCAAGTTTCTCATTC
CGGTAGGCCGGTTTTTAGT -> GGTAGGCCGGTTTTTAGTC
CGGTATCAGCAGTCGGCAT -> GGTATCAGCAGTCGGCATC
CGGTGGGTCCTCTACCTCA -> GGTGGGTCCTCTACCTCAG
CGGTGTGAAAGGGGTAGAT -> GGTGTGAAAGGGGTAGATT
CGGTTAAGTGAAAGTTCTT -> GGTTAAGTGAAAGTTCTTA
CGGTTGGGATGGGAACAAG -> GGTTGGGATGGGAACAAGA
CGGTTTATTAAGAGACAGG -> GGTTTATTAAGAGACAGGT
CGGTTTTTAGTCTGAGTAA -> GGTTTTTAGTCTGAGTAAG
CGTAACGCAGGGAGCTACT -> GTAACGCAGGGAGCTACTC
CGTACATAATGGCATTGCA -> GTACATAATGGCATTGCAA
CGTACCGACCAGGGGTAAC -> GTACCGACCAGGGGTAACA
CGTAGGGAGTATAGTATCA -> GTAGGGAGTATAGTATCAG
CGTAGGGTTCGTGGTGAAG -> GTAGGGTTCGTGGTGAAGC
CGTAGGTCCATTGACACTC -> GTAGGTCCATTGACACTCG
CGTATCGGCGGGCGATGCT -> GTATCGGCGGGCGATGCTC
CGTCCAAATAGCTGTCATC -> GTCCAAATAGCTGTCATCA
CGTCCATGCGAGTTGTGGG -> GTCCATGCGAGTTGTGGGG
CGTCCTACTTCTACAAAAC -> GTCCTACTTCTACAAAACG
CGTCGGGTGCAAGTTTCTC -> GTCGGGTGCAAGTTTCTCA
CGTCGTGCTCCACGGGGCC -> GTCGTGCTCCACGGGGCCA
CGTCTCAATTCCTCAAGTG -> GTCTCAATTCCTCAAGTGG
CGTGAAATTAGCTGCAGAG -> GTGAAATTAGCTGCAGAGT
CGTGAACCACAAGGCTCTT -> GTGAACCACAAGGCTCTTA
CGTGAATGCACGCGACCTA -> GTGAATGCACGCGACCTAA
CGTGAGAATTCGCGTCCAT -> GTGAGAATTCGCGTCCATG
CGTGATACGGAGTGGTATC -> GTGATACGGAGTGGTATCA
CGTGCTACAGAAACCGAGT -> GTGCTACAGAAACCGAGTT
CGTGCTCCACGGGGCCATT -> GTGCTCCACGGGGCCATTT
CGTGGATGTGGATGTTTCG -> GTGGATGTGGATGTTTCGA
CGTGGCTCTAGTGTACGTG -> GTGGCTCTAGTGTACGTGG
CGTGGGTAATTGGACTCTA -> GTGGGTAATTGGACTCTAC
CGTGGTGAAGCGGTTTATT -> GTGGTGAAGCGGTTTATTA
CGTTAGAAGTTGGGACCTT -> GTTAGAAGTTGGGACCTTC
CGTTAGCCTAAGTCATGAG -> GTTAGCCTAAGTCATGAGT
CGTTAGGGAAACCTGCTAG -> GTTAGGGAAACCTGCTAGT
CGTTCACCATTCATACGTG -> GTTCACCATTCATACGTGA
CGTTCATGGTGTTACTAGA -> GTTCATGGTGTTACTAGAC
CGTTGCACCAGTTTGATAC -> GTTGCACCAGTTTGATACC
CGTTGCACCAGTTTGATAG -> GTTGCACCAGTTTGATAGC,GTTGCACCAGTTTGATAGG
CGTTGCACCAGTTTGATAT -> GTTGCACCAGTTTGATATC
CGTTTGAAAGGGGGAGATA -> GTTTGAAAGGGGGAGATAT
CGTTTGTTCCCTCATTAGG -> GTTTGTTCCCTCATTAGGA
CTAAAAATGGTAAGATTCT -> TAAAAATGGTAAGATTCTG
CTAAACAATCCGCTCTAGG -> TAAACAATCCGCTCTAGGA
CTAAACCCATATTCCTTTC -> TAAACCCATATTCCTTTCG
CTAACGGAAGGTTTCTTTA -> TAACGGAAGGTTTCTTTAG
CTAACTATTGACAAATTGT -> TAACTATTGACAAATTGTC
CTAAGATCCGCCAAGGTCC -> TAAGATCCGCCAAGGTCCG
CTAAGCTCCAAATAGCCCT -> TAAGCTCCAAATAGCCCTA
CTAAGTCATGAGTTATGGA -> TAAGTCATGAGTTATGGAC
CTACAAAACGTTAGAAGTT -> TACAAAACGTTAGAAGTTG
CTACAACGATCGTTCACCA -> TACAACGATCGTTCACCAT
CTACAGAAACCGAGTTCGC -> TACAGAAACCGAGTTCGCG
CTACCTCAGCCTGGACAGA -> TACCTCAGCCTGGACAGAG
CTACGAGATGAAGCGGGCT -> TACGAGATGAAGCGGGCTC
CTACTAAAAATGGTAAGAT -> TACTAAAAATGGTAAGATT
CTACTCACGCGTGAAATTA -> TACTCACGCGTGAAATTAG
CTACTGGCTACTAAAAATG -> TACTGGCTACTAAAAATGG
CTACTTCTACAAAACGTTA -> TACTTCTACAAAACGTTAG
CTAGACGGTATCAGCAGTC -> TAGACGGTATCAGCAGTCG
CTAGACTCCGATCAGTAAA -> TAGACTCCGATCAGTAAAT
CTAGCAACCAAGAAAACCT -> TAGCAACCAAGAAAACCTG
CTAGCATCTACTGGCTACT -> TAGCATCTACTGGCTACTA
CTAGCCGAGTACTGCTGCA -> TAGCCGAGTACTGCTGCAT
CTAGCTTCTCGTGCTACAG -> TAGCTTCTCGTGCTACAGA
CTAGCTTCTGCGTTGCACC -> TAGCTTCTGCGTTGCACCA
CTAGGAAAACTTTAAGCGT -> TAGGAAAACTTTAAGCGTA
CTAGTAGATATGGAGCCTA -> TAGTAGATATGGAGCCTAA
CTAGTGTACGTGGGTAATT -> TAGTGTACGTGGGTAATTG
CTAGTTATAAGACCTTATG -> TAGTTATAAGACCTTATGA
CTAGTTTTACAATTCGCAG -> TAGTTTTACAATTCGCAGA
CTATAAAGCCCCCGCGGCC -> TATAAAGCCCCCGCGGCCC
CTATGGCACACGCAATGAG -> TATGGCACACGCAATGAGG
CTATTGACAAATTGTCTGA -> TATTGACAAATTGTCTGAA
CTCAAGTGGTACTTTCGTG -> TCAAGTGGTACTTTCGTGG
CTCAATTCCTCAAGTGGTA -> TCAATTCCTCAAGTGGTAC
CTCACCTGTGACACAGTTG -> TCACCTGTGACACAGTTGG
CTCACGCGTGAAATTAGCT -> TCACGCGTGAAATTAGCTG
CTCACGGATGCGTTGCACC -> TCACGGATGCGTTGCACCA
CTCAGCCTGGACAGAGAAA -> TCAGCCTGGACAGAGAAAC
CTCATCGTGGATGTGGATG -> TCATCGTGGATGTGGATGT
CTCATGTGGCGCTGAGTTG -> TCATGTGGCGCTGAGTTGA
CTCATGTTACGCCTTCTAT -> TCATGTTACGCCTTCTATA
CTCATTAGGAGTAGCCGCA -> TCATTAGGAGTAGCCGCAT
CTCATTCTGTGATACCGCG -> TCATTCTGTGATACCGCGG
CTCCAAATAGCCCTACGAG -> TCCAAATAGCCCTACGAGA
CTCCACGAACATGGCAACT -> TCCACGAACATGGCAACTC
CTCCACGGGGCCATTTTTT -> TCCACGGGGCCATTTTTTT
CTCCATCCTAACTATTGAC -> TCCATCCTAACTATTGACA
CTCCCACCGGATCCTGGTA -> TCCCACCGGATCCTGGTAT
CTCCCTCGGGTAACCGGGT -> TCCCTCGGGTAACCGGGTA
CTCCGATCAGTAAATGCTC -> TCCGATCAGTAAATGCTCG
CTCCGCGCGATGTGAACAT -> TCCGCGCGATGTGAACATA
CTCCGCTCGCCCTCTGTTT -> TCCGCTCGCCCTCTGTTTT
CTCCTTCGCGTACATAATG -> TCCTTCGCGTACATAATGG
CTCGAGTCTGCTCCCACCG -> TCGAGTCTGCTCCCACCGG
CTCGCCCTCTGTTTTCGGG -> TCGCCCTCTGTTTTCGGGC
CTCGCGGTGTGAAAGGGGT -> TCGCGGTGTGAAAGGGGTA
CTCGGGTAACCGGGTAGTG -> TCGGGTAACCGGGTAGTGC
CTCGTCTCAATTCCTCAAG -> TCGTCTCAATTCCTCAAGT
CTCGTGCTACAGAAACCGA -> TCGTGCTACAGAAACCGAG
CTCGTTAGGGAAACCTGCT -> TCGTTAGGGAAACCTGCTA
CTCGTTTGTTCCCTCATTA -> TCGTTTGTTCCCTCATTAG
CTCTACAACGATCGTTCAC -> TCTACAACGATCGTTCACC
CTCTACCTCAGCCTGGACA -> TCTACCTCAGCCTGGACAG
CTCTAGGAAAACTTTAAGC -> TCTAGGAAAACTTTAAGCG
CTCTAGTGTACGTGGGTAA -> TCTAGTGTACGTGGGTAAT
CTCTGTTTTCGGGCTAACG -> TCTGTTTTCGGGCTAACGG
CTCTTATGTATAAGCAGCT -> TCTTATGTATAAGCAGCTA
CTGAAAAGTTTTTCCCGCG -> TGAAAAGTTTTTCCCGCGC
CTGAAACGCGTTGCACCAG -> TGAAACGCGTTGCACCAGT
CTGAAATCGCGCTCGAGTC -> TGAAATCGCGCTCGAGTCT
CTGAACGACCGGCGTAGGG -> TGAACGACCGGCGTAGGGT
CTGAGTAAGTGCTGGCACG -> TGAGTAAGTGCTGGCACGG
CTGAGTTGAAGCCTTCGAC -> TGAGTTGAAGCCTTCGACC
CTGCACACCTGTTCAACGA -> TGCACACCTGTTCAACGAT
CTGCAGAGTTCAATAAAAG -> TGCAGAGTTCAATAAAAGG
CTGCAGAGTTCAATCAGAC -> TGCAGAGTTCAATCAGACT
CTGCAGAGTTCAATGGCTA -> TGCAGAGTTCAATGGCTAG
CTGCAGAGTTCAATTTCTC -> TGCAGAGTTCAATTTCTCA
CTGCATAGGAAAGAAAGTC -> TGCATAGGAAAGAAAGTCA
CTGCCACTAAGCTCCAAAT -> TGCCACTAAGCTCCAAATA
CTGCGTTGCACCAGTTTGA -> TGCGTTGCACCAGTTTGAT
CTGCTAGTTATAAGACCTT -> TGCTAGTTATAAGACCTTA
CTGCTCCCACCGGATCCTG -> TGCTCCCACCGGATCCTGG
CTGCTGCATAGGAAAGAAA -> TGCTGCATAGGAAAGAAAG
CTGGACAGAGAAACCGATC -> TGGACAGAGAAACCGATCT
CTGGACCGTATCGGCGGGC -> TGGACCGTATCGGCGGGCG
CTGGCACGGGGATGATAAT -> TGGCACGGGGATGATAATT
CTGGCACTGGACCGTATCG -> TGGCACTGGACCGTATCGG
CTGGCCGATTGCGTCCAAA -> TGGCCGATTGCGTCCAAAT
CTGGCCGTGATACGGAGTG -> TGGCCGTGATACGGAGTGG
CTGGCGTTCATGGTGTTAC -> TGGCGTTCATGGTGTTACT
CTGGCTACTAAAAATGGTA -> TGGCTACTAAAAATGGTAA
CTGGTATACGTCGGGTGCA -> TGGTATACGTCGGGTGCAA
CTGTCATCATAGGAAAGAA -> TGTCATCATAGGAAAGAAA
CTGTGACACAGTTGGTTCG -> TGTGACACAGTTGGTTCGC
CTGTGATACCGCGGAGGTA -> TGTGATACCGCGGAGGTAG
CTGTTATGTGGGTACTAGT -> TGTTATGTGGGTACTAGTT
CTGTTCAACGATTTCCGAA -> TGTTCAACGATTTCCGAAT
CTGTTGCTTAGCTGCAGAG -> TGTTGCTTAGCTGCAGAGT
CTGTTTTCGGGCTAACGGA -> TGTTTTCGGGCTAACGGAA
CTTAGCAGGAATACGCTCA -> TTAGCAGGAATACGCTCAC
CTTAGCGCTGGCCGATTGC -> TTAGCGCTGGCCGATTGCG
CTTAGCTGAAATCGCGCTC -> TTAGCTGAAATCGCGCTCG
CTTAGCTGCAGAGTTCAAT -> TTAGCTGCAGAGTTCAATC
CTTATCCAGTTACAACCTC -> TTATCCAGTTACAACCTCC
CTTATGAGCGTAACGCAGG -> TTATGAGCGTAACGCAGGG
CTTATGTATAAGCAGCTAG -> TTATGTATAAGCAGCTAGT
CTTATGTCTAGCAACCAAG -> TTATGTCTAGCAACCAAGA
CTTCCGTACCGACCAGGGG -> TTCCGTACCGACCAGGGGT
CTTCCTGGCCGTGATACGG -> TTCCTGGCCGTGATACGGA
CTTCGACCAATAACCTAGC -> TTCGACCAATAACCTAGCT
CTTCGCGTACATAATGGCA -> TTCGCGTACATAATGGCAT
CTTCTACAAAACGTTAGAA -> TTCTACAAAACGTTAGAAG
CTTCTATAAAGCCCCCGCG -> TTCTATAAAGCCCCCGCGG
CTTCTCGTGCTACAGAAAC -> TTCTCGTGCTACAGAAACC
CTTCTGCGTTGCACCAGTT -> TTCTGCGTTGCACCAGTTT
CTTGTGTATGGGCACCTTC -> TTGTGTATGGGCACCTTCC
CTTTAAGCGTAGGTCCATT -> TTTAAGCGTAGGTCCATTG
CTTTAGCTCATGTGGCGCT -> TTTAGCTCATGTGGCGCTG
CTTTCCGCATAAGCAAGGA -> TTTCCGCATAAGCAAGGAG
CTTTCGAGGCATTACCGCA -> TTTCGAGGCATTACCGCAC
CTTTCGTGGCTCTAGTGTA -> TTTCGTGGCTCTAGTGTAC
GAAAACCTGCCACTAAGCT -> AAAACCTGCCACTAAGCTC
GAAAACTTTAAGCGTAGGT -> AAAACTTTAAGCGTAGGTC
GAAAAGTATGGTTAGCTGC -> AAAAGTATGGTTAGCTGCA
GAAAAGTTTTTCCCGCGCT -> AAAAGTTTTTCCCGCGCTT
GAAACCGAGTTCGCGATTG -> AAACCGAGTTCGCGATTGC
GAAACCGATCTTAGCTGAA -> AAACCGATCTTAGCTGAAA
GAAACCTGCTAGTTATAAG -> AAACCTGCTAGTTATAAGA
GAAACGCGTTGCACCAGTT -> AAACGCGTTGCACCAGTTT
GAAACTAGCATCTACTGGC -> AAACTAGCATCTACTGGCT
GAAAGAAACTAGCATCTAC -> AAAGAAACTAGCATCTACT
GAAAGAAAGTCAGCGGCGC -> AAAGAAAGTCAGCGGCGCA
GAAAGCAGTGAGATCACGG -> AAAGCAGTGAGATCACGGA
GAAAGGGGGAGATATATAA -> AAAGGGGGAGATATATAAG
GAAAGGGGTAGATTGCCGT -> AAAGGGGTAGATTGCCGTA
GAAAGTCAGCGGCGCAGAG -> AAAGTCAGCGGCGCAGAGT
GAAAGTTCTTAGCAGGAAT -> AAAGTTCTTAGCAGGAATA
GAAATCGCGCTCGAGTCTG -> AAATCGCGCTCGAGTCTGC
GAAATTAGCTGCAGAGTTC -> AAATTAGCTGCAGAGTTCA
GAACAAGAAGAACTGAAAA -> AACAAGAAGAACTGAAAAG
GAACATAAGCCGATTACTC -> AACATAAGCCGATTACTCC
GAACATGGCAACTCAGAAT -> AACATGGCAACTCAGAATA
GAACCACAAGGCTCTTATG -> AACCACAAGGCTCTTATGT
GAACGACCGGCGTAGGGTT -> AACGACCGGCGTAGGGTTC
GAACGATGACAATGTCACT -> AACGATGACAATGTCACTC
GAACTGAAAAGTTTTTCCC -> AACTGAAAAGTTTTTCCCG
GAAGAACTGAAAAGTTTTT -> AAGAACTGAAAAGTTTTTC
GAAGCCTTCGACCAATAAC -> AAGCCTTCGACCAATAACC
GAAGCGGGCTCCGCTCGCC -> AAGCGGGCTCCGCTCGCCC
GAAGCGGTTTATTAAGAGA -> AAGCGGTTTATTAAGAGAC
GAAGCTTATCCAGTTACAA -> AAGCTTATCCAGTTACAAC
GAAGGTTTCTTTAGCTCAT -> AAGGTTTCTTTAGCTCATG
GAAGTTGGGACCTTCCTGG -> AAGTTGGGACCTTCCTGGC
GAATAATAGTGATCACGGG -> AATAATAGTGATCACGGGC
GAATACGCTCACCTGTGAC -> AATACGCTCACCTGTGACA
GAATGCACGCGACCTAAGA -> AATGCACGCGACCTAAGAT
GAATTCGCGTCCATGCGAG -> AATTCGCGTCCATGCGAGT
GACAAAGTGGACAAATCGA -> ACAAAGTGGACAAATCGAC
GACAAATCGACAATTTTCG -> ACAAATCGACAATTTTCGG
GACAAATTGTCTGAACGAC -> ACAAATTGTCTGAACGACC
GACAATGTCACTCATCGTG -> ACAATGTCACTCATCGTGG
GACAATTTTCGGACGGATT -> ACAATTTTCGGACGGATTA
GACACAGCGTCGTGCTCCA -> ACACAGCGTCGTGCTCCAC
GACACAGTTGGTTCGCCCA -> ACACAGTTGGTTCGCCCAT
GACACTCGTTAGGGAAACC -> ACACTCGTTAGGGAAACCT
GACAGAGAAACCGATCTTA -> ACAGAGAAACCGATCTTAG
GACAGGTTTGGTCAGCGGT -> ACAGGTTTGGTCAGCGGTG
GACCAATAACCTAGCTTCT -> ACCAATAACCTAGCTTCTC
GACCACCCAACAGGCGTGA -> ACCACCCAACAGGCGTGAG
GACCAGGGGTAACACCGCC -> ACCAGGGGTAACACCGCCG
GACCCGGTTGGGATGGGAA -> ACCCGGTTGGGATGGGAAC
GACCGGCGTAGGGTTCGTG -> ACCGGCGTAGGGTTCGTGG
GACCGTATCGGCGGGCGAT -> ACCGTATCGGCGGGCGATG
GACCTAAGATCCGCCAAGG -> ACCTAAGATCCGCCAAGGT
GACCTTATGAGCGTAACGC -> ACCTTATGAGCGTAACGCA
GACCTTCCTGGCCGTGATA -> ACCTTCCTGGCCGTGATAC
GACGATTGAAAGCAGTGAG -> ACGATTGAAAGCAGTGAGA
GACGGATTAGGCGAAAAGT -> ACGGATTAGGCGAAAAGTA
GACGGGAGGACGTGAACCA -> ACGGGAGGACGTGAACCAC
GACGGGTCTAGACGGTATC -> ACGGGTCTAGACGGTATCA
GACGGTATCAGCAGTCGGC -> ACGGTATCAGCAGTCGGCA
GACGTGAACCACAAGGCTC -> ACGTGAACCACAAGGCTCT
GACTCCGATCAGTAAATGC -> ACTCCGATCAGTAAATGCT
GACTCTACAACGATCGTTC -> ACTCTACAACGATCGTTCA
GACTGAAACGCGTTGCACC -> ACTGAAACGCGTTGCACCA
GACTGCACACCTGTTCAAC -> ACTGCACACCTGTTCAACG
GACTGGCGTTCATGGTGTT -> ACTGGCGTTCATGGTGTTA
GAGAAACCGATCTTAGCTG -> AGAAACCGATCTTAGCTGA
GAGAATTCGCGTCCATGCG -> AGAATTCGCGTCCATGCGA
GAGACAAAGTGGACAAATC -> AGACAAAGTGGACAAATCG
GAGACAGGTTTGGTCAGCG -> AGACAGGTTTGGTCAGCGG
GAGAGATTTGACCACCCAA -> AGAGATTTGACCACCCAAC
GAGATATATAAGGAGTCTA -> AGATATATAAGGAGTCTAT
GAGATCACGGAACGATGAC -> AGATCACGGAACGATGACA
GAGATGAAGCGGGCTCCGC -> AGATGAAGCGGGCTCCGCT
GAGATTTGACCACCCAACA -> AGATTTGACCACCCAACAG
GAGCCAGGCTAGCCGAGTA -> AGCCAGGCTAGCCGAGTAC
GAGCCTAAACAATCCGCTC -> AGCCTAAACAATCCGCTCT
GAGCGTAACGCAGGGAGCT -> AGCGTAACGCAGGGAGCTA
GAGCTACTCACGCGTGAAA -> AGCTACTCACGCGTGAAAT
GAGGACGTGAACCACAAGG -> AGGACGTGAACCACAAGGC
GAGGCAAAGACCCGGTTGG -> AGGCAAAGACCCGGTTGGG
GAGGCACGGCGTCCTACTT -> AGGCACGGCGTCCTACTTC
GAGGCATTACCGCACCCTC -> AGGCATTACCGCACCCTCG
GAGGTAGAGGTTAGACGAT -> AGGTAGAGGTTAGACGATT
GAGGTGGTCGGTTAAGTGA -> AGGTGGTCGGTTAAGTGAA
GAGGTTAGACGATTGAAAG -> AGGTTAGACGATTGAAAGC
GAGTAAGTGCTGGCACGGG -> AGTAAGTGCTGGCACGGGG
GAGTACTGCTGCATAGGAA -> AGTACTGCTGCATAGGAAA
GAGTAGCCGCATATGGGTG -> AGTAGCCGCATATGGGTGG
GAGTATAGTATCAGGTTTA -> AGTATAGTATCAGGTTTAC
GAGTCTATGGCACACGCAA -> AGTCTATGGCACACGCAAT
GAGTCTGCTCCCACCGGAT -> AGTCTGCTCCCACCGGATC
GAGTGAGAGATTTGACCAC -> AGTGAGAGATTTGACCACC
GAGTGCGACTGGCGTTCAT -> AGTGCGACTGGCGTTCATG
GAGTGGTATCAACCAACCC -> AGTGGTATCAACCAACCCA
GAGTTATGGACGGGAGGAC -> AGTTATGGACGGGAGGACG
GAGTTCAATAAAAGGTTGC -> AGTTCAATAAAAGGTTGCG
GAGTTCAATCAGACTGAAA -> AGTTCAATCAGACTGAAAC
GAGTTCAATGGCTAGCTTC -> AGTTCAATGGCTAGCTTCT
GAGTTCAATTTCTCACGGA -> AGTTCAATTTCTCACGGAT
GAGTTCGCGATTGCAAGCT -> AGTTCGCGATTGCAAGCTA
GAGTTGAAGCCTTCGACCA -> AGTTGAAGCCTTCGACCAA
GAGTTGTGGGGAGGTGGTC -> AGTTGTGGGGAGGTGGTCG
GATAATTGGAGTGAGAGAT -> ATAATTGGAGTGAGAGATT
GATACCACTTTCCGCATAA -> ATACCACTTTCCGCATAAG
GATACCGCGGAGGTAGAGG -> ATACCGCGGAGGTAGAGGT
GATACGGAGTGGTATCAAC -> ATACGGAGTGGTATCAACC
GATAGCGCCAAACAGAAGC -> ATAGCGCCAAACAGAAGCT
GATAGCGCCCTGGCACTGG -> ATAGCGCCCTGGCACTGGA
GATAGGCAGGGCAATTTGT -> ATAGGCAGGGCAATTTGTC
GATATATAAGGAGTCTATG -> ATATATAAGGAGTCTATGG
GATATCATTGTGACGGGTC -> ATATCATTGTGACGGGTCT
GATATGGAGCCTAAACAAT -> ATATGGAGCCTAAACAATC
GATCACGGAACGATGACAA -> ATCACGGAACGATGACAAT
GATCACGGGCTGTTGCTTA -> ATCACGGGCTGTTGCTTAG
GATCAGTAAATGCTCGTCT -> ATCAGTAAATGCTCGTCTC
GATCCGCCAAGGTCCGCCG -> ATCCGCCAAGGTCCGCCGG
GATCCTGGTATACGTCGGG -> ATCCTGGTATACGTCGGGT
GATCGTTCACCATTCATAC -> ATCGTTCACCATTCATACG
GATCTTAGCTGAAATCGCG -> ATCTTAGCTGAAATCGCGC
GATGAAGCGGGCTCCGCTC -> ATGAAGCGGGCTCCGCTCG
GATGACAATGTCACTCATC -> ATGACAATGTCACTCATCG
GATGATAATTGGAGTGAGA -> ATGATAATTGGAGTGAGAG
GATGCGTTGCACCAGTTTG -> ATGCGTTGCACCAGTTTGA
GATGCTCCTTCGCGTACAT -> ATGCTCCTTCGCGTACATA
GATGGGAACAAGAAGAACT -> ATGGGAACAAGAAGAACTG
GATGTGAACATAAGCCGAT -> ATGTGAACATAAGCCGATT
GATGTGGATGTTTCGATAG -> ATGTGGATGTTTCGATAGC
GATGTTTCGATAGCGCCCT -> ATGTTTCGATAGCGCCCTG
GATTACTCCCTCGGGTAAC -> ATTACTCCCTCGGGTAACC
GATTAGGCGAAAAGTATGG -> ATTAGGCGAAAAGTATGGT
GATTCTGTTATGTGGGTAC -> ATTCTGTTATGTGGGTACT
GATTGAAAGCAGTGAGATC -> ATTGAAAGCAGTGAGATCA
GATTGCAAGCTAAACCCAT -> ATTGCAAGCTAAACCCATA
GATTGCCGTAGGGAGTATA -> ATTGCCGTAGGGAGTATAG
GATTGCGTCCAAATAGCTG -> ATTGCGTCCAAATAGCTGT
GATTTCCGAATAATAGTGA -> ATTTCCGAATAATAGTGAT
GATTTGACCACCCAACAGG -> ATTTGACCACCCAACAGGC
GCAAAGACCCGGTTGGGAT -> CAAAGACCCGGTTGGGATG
GCAACCAAGAAAACCTGCC -> CAACCAAGAAAACCTGCCA
GCAAGCTAAACCCATATTC -> CAAGCTAAACCCATATTCC
GCAAGGAGACAAAGTGGAC -> CAAGGAGACAAAGTGGACA
GCAAGGCAGGCTTATGTCT -> CAAGGCAGGCTTATGTCTA
GCAAGTTCAATCAACGAGC -> CAAGTTCAATCAACGAGCC
GCAAGTTTCTCATTCTGTG -> CAAGTTTCTCATTCTGTGA
GCAATGAGGCAAAGACCCG -> CAATGAGGCAAAGACCCGG
GCAATTTGTCCTCCATCCT -> CAATTTGTCCTCCATCCTA
GCACACCTGTTCAACGATT -> CACACCTGTTCAACGATTT
GCACACGCAATGAGGCAAA -> CACACGCAATGAGGCAAAG
GCACCAGTTTGATACCACT -> CACCAGTTTGATACCACTT
GCACCAGTTTGATAGCGCC -> CACCAGTTTGATAGCGCCA
GCACCAGTTTGATAGGCAG -> CACCAGTTTGATAGGCAGG
GCACCAGTTTGATATCATT -> CACCAGTTTGATATCATTG
GCACCCTCGCGGTGTGAAA -> CACCCTCGCGGTGTGAAAG
GCACCTTCCGTACCGACCA -> CACCTTCCGTACCGACCAG
GCACGCGACCTAAGATCCG -> CACGCGACCTAAGATCCGC
GCACGGCGTCCTACTTCTA -> CACGGCGTCCTACTTCTAC
GCACGGGGATGATAATTGG -> CACGGGGATGATAATTGGA
GCACTGGACCGTATCGGCG -> CACTGGACCGTATCGGCGG
GCAGACACAGCGTCGTGCT -> CAGACACAGCGTCGTGCTC
GCAGAGTGCGACTGGCGTT -> CAGAGTGCGACTGGCGTTC
GCAGAGTTCAATAAAAGGT -> CAGAGTTCAATAAAAGGTT
GCAGAGTTCAATCAGACTG -> CAGAGTTCAATCAGACTGA
GCAGAGTTCAATGGCTAGC -> CAGAGTTCAATGGCTAGCT
GCAGAGTTCAATTTCTCAC -> CAGAGTTCAATTTCTCACG
GCAGCTAGTAGATATGGAG -> CAGCTAGTAGATATGGAGC
GCAGGAATACGCTCACCTG -> CAGGAATACGCTCACCTGT
GCAGGCTTATGTCTAGCAA -> CAGGCTTATGTCTAGCAAC
GCAGGGAGCTACTCACGCG -> CAGGGAGCTACTCACGCGT
GCAGGGCAATTTGTCCTCC -> CAGGGCAATTTGTCCTCCA
GCAGTCGGCATCCGTTAGC -> CAGTCGGCATCCGTTAGCC
GCAGTGAGATCACGGAACG -> CAGTGAGATCACGGAACGA
GCATAACAGGTCATCAAAT -> CATAACAGGTCATCAAATT
GCATAAGCAAGGAGACAAA -> CATAAGCAAGGAGACAAAG
GCATAGGAAAGAAAGTCAG -> CATAGGAAAGAAAGTCAGC
GCATATGGGTGGAGGCACG -> CATATGGGTGGAGGCACGG
GCATCCGTTAGCCTAAGTC -> CATCCGTTAGCCTAAGTCA
GCATCTACTGGCTACTAAA -> CATCTACTGGCTACTAAAA
GCATTACCGCACCCTCGCG -> CATTACCGCACCCTCGCGG
GCATTGCAAGGCAGGCTTA -> CATTGCAAGGCAGGCTTAT
GCCAAACAGAAGCTTATCC -> CCAAACAGAAGCTTATCCA
GCCAAGGTCCGCCGGTAGG -> CCAAGGTCCGCCGGTAGGC
GCCACTAAGCTCCAAATAG -> CCACTAAGCTCCAAATAGC
GCCAGGCTAGCCGAGTACT -> CCAGGCTAGCCGAGTACTG
GCCATTTTTTTACGCTCGT -> CCATTTTTTTACGCTCGTT
GCCCACTTAGCGCTGGCCG -> CCCACTTAGCGCTGGCCGA
GCCCATGGTCAGCATAACA -> CCCATGGTCAGCATAACAG
GCCCCCGCGGCCCACTTAG -> CCCCCGCGGCCCACTTAGC
GCCCTACGAGATGAAGCGG -> CCCTACGAGATGAAGCGGG
GCCCTCTGTTTTCGGGCTA -> CCCTCTGTTTTCGGGCTAA
GCCCTGGCACTGGACCGTA -> CCCTGGCACTGGACCGTAT
GCCGACTGCACACCTGTTC -> CCGACTGCACACCTGTTCA
GCCGAGTACTGCTGCATAG -> CCGAGTACTGCTGCATAGG
GCCGATTACTCCCTCGGGT -> CCGATTACTCCCTCGGGTA
GCCGATTGCGTCCAAATAG -> CCGATTGCGTCCAAATAGC
GCCGCATATGGGTGGAGGC -> CCGCATATGGGTGGAGGCA
GCCGGTAGGCCGGTTTTTA -> CCGGTAGGCCGGTTTTTAG
GCCGGTTTTTAGTCTGAGT -> CCGGTTTTTAGTCTGAGTA
GCCGTAGGGAGTATAGTAT -> CCGTAGGGAGTATAGTATC
GCCGTGATACGGAGTGGTA -> CCGTGATACGGAGTGGTAT
GCCTAAACAATCCGCTCTA -> CCTAAACAATCCGCTCTAG
GCCTAAGTCATGAGTTATG -> CCTAAGTCATGAGTTATGG
GCCTGGACAGAGAAACCGA -> CCTGGACAGAGAAACCGAT
GCCTTCGACCAATAACCTA -> CCTTCGACCAATAACCTAG
GCCTTCTATAAAGCCCCCG -> CCTTCTATAAAGCCCCCGC
GCGAAAAGTATGGTTAGCT -> CGAAAAGTATGGTTAGCTG
GCGACCTAAGATCCGCCAA -> CGACCTAAGATCCGCCAAG
GCGACTGGCGTTCATGGTG -> CGACTGGCGTTCATGGTGT
GCGAGTTGTGGGGAGGTGG -> CGAGTTGTGGGGAGGTGGT
GCGATGCTCCTTCGCGTAC -> CGATGCTCCTTCGCGTACA
GCGATGTGAACATAAGCCG -> CGATGTGAACATAAGCCGA
GCGATTGCAAGCTAAACCC -> CGATTGCAAGCTAAACCCA
GCGCAGAGTGCGACTGGCG -> CGCAGAGTGCGACTGGCGT
GCGCCAAACAGAAGCTTAT -> CGCCAAACAGAAGCTTATC
GCGCCCTGGCACTGGACCG -> CGCCCTGGCACTGGACCGT
GCGCGATGTGAACATAAGC -> CGCGATGTGAACATAAGCC
GCGCTCGAGTCTGCTCCCA -> CGCTCGAGTCTGCTCCCAC
GCGCTGAGTTGAAGCCTTC -> CGCTGAGTTGAAGCCTTCG
GCGCTGGCCGATTGCGTCC -> CGCTGGCCGATTGCGTCCA
GCGCTTGTGTATGGGCACC -> CGCTTGTGTATGGGCACCT
GCGGAGGTAGAGGTTAGAC -> CGGAGGTAGAGGTTAGACG
GCGGCCCACTTAGCGCTGG -> CGGCCCACTTAGCGCTGGC
GCGGCGCAGAGTGCGACTG -> CGGCGCAGAGTGCGACTGG
GCGGCGTTGCACCAGTTTG -> CGGCGTTGCACCAGTTTGA
GCGGGCGATGCTCCTTCGC -> CGGGCGATGCTCCTTCGCG
GCGGGCTCCGCTCGCCCTC -> CGGGCTCCGCTCGCCCTCT
GCGGTGGGTCCTCTACCTC -> CGGTGGGTCCTCTACCTCA
GCGGTGTGAAAGGGGTAGA -> CGGTGTGAAAGGGGTAGAT
GCGGTTTATTAAGAGACAG -> CGGTTTATTAAGAGACAGG
GCGTAACGCAGGGAGCTAC -> CGTAACGCAGGGAGCTACT
GCGTACATAATGGCATTGC -> CGTACATAATGGCATTGCA
GCGTAGGGTTCGTGGTGAA -> CGTAGGGTTCGTGGTGAAG
GCGTAGGTCCATTGACACT -> CGTAGGTCCATTGACACTC
GCGTCCAAATAGCTGTCAT -> CGTCCAAATAGCTGTCATC
GCGTCCATGCGAGTTGTGG -> CGTCCATGCGAGTTGTGGG
GCGTCCTACTTCTACAAAA -> CGTCCTACTTCTACAAAAC
GCGTCGTGCTCCACGGGGC -> CGTCGTGCTCCACGGGGCC
GCGTGAAATTAGCTGCAGA -> CGTGAAATTAGCTGCAGAG
GCGTGAGAATTCGCGTCCA -> CGTGAGAATTCGCGTCCAT
GCGTTCATGGTGTTACTAG -> CGTTCATGGTGTTACTAGA
GCGTTGCACCAGTTTGATA -> CGTTGCACCAGTTTGATAC,CGTTGCACCAGTTTGATAG,CGTTGCACCAGTTTGATAG,CGTTGCACCAGTTTGATAT
GCTAAACCCATATTCCTTT -> CTAAACCCATATTCCTTTC
GCTAACGGAAGGTTTCTTT -> CTAACGGAAGGTTTCTTTA
GCTACAGAAACCGAGTTCG -> CTACAGAAACCGAGTTCGC
GCTACTAAAAATGGTAAGA -> CTACTAAAAATGGTAAGAT
GCTACTCACGCGTGAAATT -> CTACTCACGCGTGAAATTA
GCTAGCCGAGTACTGCTGC -> CTAGCCGAGTACTGCTGCA
GCTAGCTTCTGCGTTGCAC -> CTAGCTTCTGCGTTGCACC
GCTAGTAGATATGGAGCCT -> CTAGTAGATATGGAGCCTA
GCTAGTTATAAGACCTTAT -> CTAGTTATAAGACCTTATG
GCTCACCTGTGACACAGTT -> CTCACCTGTGACACAGTTG
GCTCATGTGGCGCTGAGTT -> CTCATGTGGCGCTGAGTTG
GCTCCAAATAGCCCTACGA -> CTCCAAATAGCCCTACGAG
GCTCCACGGGGCCATTTTT -> CTCCACGGGGCCATTTTTT
GCTCCCACCGGATCCTGGT -> CTCCCACCGGATCCTGGTA
GCTCCGCTCGCCCTCTGTT -> CTCCGCTCGCCCTCTGTTT
GCTCCTTCGCGTACATAAT -> CTCCTTCGCGTACATAATG
GCTCGAGTCTGCTCCCACC -> CTCGAGTCTGCTCCCACCG
GCTCGCCCTCTGTTTTCGG -> CTCGCCCTCTGTTTTCGGG
GCTCGTCTCAATTCCTCAA -> CTCGTCTCAATTCCTCAAG
GCTCGTTTGTTCCCTCATT -> CTCGTTTGTTCCCTCATTA
GCTCTAGGAAAACTTTAAG -> CTCTAGGAAAACTTTAAGC
GCTCTAGTGTACGTGGGTA -> CTCTAGTGTACGTGGGTAA
GCTCTTATGTATAAGCAGC -> CTCTTATGTATAAGCAGCT
GCTGAAATCGCGCTCGAGT -> CTGAAATCGCGCTCGAGTC
GCTGAGTTGAAGCCTTCGA -> CTGAGTTGAAGCCTTCGAC
GCTGCAGAGTTCAATAAAA -> CTGCAGAGTTCAATAAAAG
GCTGCAGAGTTCAATCAGA -> CTGCAGAGTTCAATCAGAC
GCTGCAGAGTTCAATGGCT -> CTGCAGAGTTCAATGGCTA
GCTGCAGAGTTCAATTTCT -> CTGCAGAGTTCAATTTCTC
GCTGCATAGGAAAGAAAGT -> CTGCATAGGAAAGAAAGTC
GCTGGCACGGGGATGATAA -> CTGGCACGGGGATGATAAT
GCTGGCCGATTGCGTCCAA -> CTGGCCGATTGCGTCCAAA
GCTGTCATCATAGGAAAGA -> CTGTCATCATAGGAAAGAA
GCTGTTGCTTAGCTGCAGA -> CTGTTGCTTAGCTGCAGAG
GCTTAGCTGCAGAGTTCAA -> CTTAGCTGCAGAGTTCAAT
GCTTATCCAGTTACAACCT -> CTTATCCAGTTACAACCTC
GCTTATGTCTAGCAACCAA -> CTTATGTCTAGCAACCAAG
GCTTCTCGTGCTACAGAAA -> CTTCTCGTGCTACAGAAAC
GCTTCTGCGTTGCACCAGT -> CTTCTGCGTTGCACCAGTT
GCTTGTGTATGGGCACCTT -> CTTGTGTATGGGCACCTTC
GGAAAACTTTAAGCGTAGG -> GAAAACTTTAAGCGTAGGT
GGAAACCTGCTAGTTATAA -> GAAACCTGCTAGTTATAAG
GGAAAGAAACTAGCATCTA -> GAAAGAAACTAGCATCTAC
GGAAAGAAAGTCAGCGGCG -> GAAAGAAAGTCAGCGGCGC
GGAACAAGAAGAACTGAAA -> GAACAAGAAGAACTGAAAA
GGAACGATGACAATGTCAC -> GAACGATGACAATGTCACT
GGAAGGTTTCTTTAGCTCA -> GAAGGTTTCTTTAGCTCAT
GGAATACGCTCACCTGTGA -> GAATACGCTCACCTGTGAC
GGACAAATCGACAATTTTC -> GACAAATCGACAATTTTCG
GGACAGAGAAACCGATCTT -> GACAGAGAAACCGATCTTA
GGACCGTATCGGCGGGCGA -> GACCGTATCGGCGGGCGAT
GGACCTTCCTGGCCGTGAT -> GACCTTCCTGGCCGTGATA
GGACGGATTAGGCGAAAAG -> GACGGATTAGGCGAAAAGT
GGACGGGAGGACGTGAACC -> GACGGGAGGACGTGAACCA
GGACGTGAACCACAAGGCT -> GACGTGAACCACAAGGCTC
GGACTCTACAACGATCGTT -> GACTCTACAACGATCGTTC
GGAGACAAAGTGGACAAAT -> GAGACAAAGTGGACAAATC
GGAGATATATAAGGAGTCT -> GAGATATATAAGGAGTCTA
GGAGCCTAAACAATCCGCT -> GAGCCTAAACAATCCGCTC
GGAGCTACTCACGCGTGAA -> GAGCTACTCACGCGTGAAA
GGAGGACGTGAACCACAAG -> GAGGACGTGAACCACAAGG
GGAGGCACGGCGTCCTACT -> GAGGCACGGCGTCCTACTT
GGAGGTAGAGGTTAGACGA -> GAGGTAGAGGTTAGACGAT
GGAGGTGGTCGGTTAAGTG -> GAGGTGGTCGGTTAAGTGA
GGAGTAGCCGCATATGGGT -> GAGTAGCCGCATATGGGTG
GGAGTATAGTATCAGGTTT -> GAGTATAGTATCAGGTTTA
GGAGTCTATGGCACACGCA -> GAGTCTATGGCACACGCAA
GGAGTGAGAGATTTGACCA -> GAGTGAGAGATTTGACCAC
GGAGTGGTATCAACCAACC -> GAGTGGTATCAACCAACCC
GGATCCTGGTATACGTCGG -> GATCCTGGTATACGTCGGG
GGATGATAATTGGAGTGAG -> GATGATAATTGGAGTGAGA
GGATGCGTTGCACCAGTTT -> GATGCGTTGCACCAGTTTG
GGATGGGAACAAGAAGAAC -> GATGGGAACAAGAAGAACT
GGATGTGGATGTTTCGATA -> GATGTGGATGTTTCGATAG
GGATGTTTCGATAGCGCCC -> GATGTTTCGATAGCGCCCT
GGATTAGGCGAAAAGTATG -> GATTAGGCGAAAAGTATGG
GGCAAAGACCCGGTTGGGA -> GCAAAGACCCGGTTGGGAT
GGCAATTTGTCCTCCATCC -> GCAATTTGTCCTCCATCCT
GGCACACGCAATGAGGCAA -> GCACACGCAATGAGGCAAA
GGCACCTTCCGTACCGACC -> GCACCTTCCGTACCGACCA
GGCACGGCGTCCTACTTCT -> GCACGGCGTCCTACTTCTA
GGCACGGGGATGATAATTG -> GCACGGGGATGATAATTGG
GGCACTGGACCGTATCGGC -> GCACTGGACCGTATCGGCG
GGCAGGCTTATGTCTAGCA -> GCAGGCTTATGTCTAGCAA
GGCAGGGCAATTTGTCCTC -> GCAGGGCAATTTGTCCTCC
GGCATCCGTTAGCCTAAGT -> GCATCCGTTAGCCTAAGTC
GGCATTACCGCACCCTCGC -> GCATTACCGCACCCTCGCG
GGCATTGCAAGGCAGGCTT -> GCATTGCAAGGCAGGCTTA
GGCCATTTTTTTACGCTCG -> GCCATTTTTTTACGCTCGT
GGCCCACTTAGCGCTGGCC -> GCCCACTTAGCGCTGGCCG
GGCCGATTGCGTCCAAATA -> GCCGATTGCGTCCAAATAG
GGCCGGTTTTTAGTCTGAG -> GCCGGTTTTTAGTCTGAGT
GGCCGTGATACGGAGTGGT -> GCCGTGATACGGAGTGGTA
GGCGAAAAGTATGGTTAGC -> GCGAAAAGTATGGTTAGCT
GGCGATGCTCCTTCGCGTA -> GCGATGCTCCTTCGCGTAC
GGCGCAGAGTGCGACTGGC -> GCGCAGAGTGCGACTGGCG
GGCGCTGAGTTGAAGCCTT -> GCGCTGAGTTGAAGCCTTC
GGCGGGCGATGCTCCTTCG -> GCGGGCGATGCTCCTTCGC
GGCGTAGGGTTCGTGGTGA -> GCGTAGGGTTCGTGGTGAA
GGCGTCCTACTTCTACAAA -> GCGTCCTACTTCTACAAAA
GGCGTGAGAATTCGCGTCC -> GCGTGAGAATTCGCGTCCA
GGCGTTCATGGTGTTACTA -> GCGTTCATGGTGTTACTAG
GGCGTTGCACCAGTTTGAT -> GCGTTGCACCAGTTTGATA
GGCTAACGGAAGGTTTCTT -> GCTAACGGAAGGTTTCTTT
GGCTACTAAAAATGGTAAG -> GCTACTAAAAATGGTAAGA
GGCTAGCCGAGTACTGCTG -> GCTAGCCGAGTACTGCTGC
GGCTAGCTTCTGCGTTGCA -> GCTAGCTTCTGCGTTGCAC
GGCTCCGCTCGCCCTCTGT -> GCTCCGCTCGCCCTCTGTT
GGCTCTAGTGTACGTGGGT -> GCTCTAGTGTACGTGGGTA
GGCTCTTATGTATAAGCAG -> GCTCTTATGTATAAGCAGC
GGCTGTTGCTTAGCTGCAG -> GCTGTTGCTTAGCTGCAGA
GGCTTATGTCTAGCAACCA -> GCTTATGTCTAGCAACCAA
GGGAAACCTGCTAGTTATA -> GGAAACCTGCTAGTTATAA
GGGAACAAGAAGAACTGAA -> GGAACAAGAAGAACTGAAA
GGGACCTTCCTGGCCGTGA -> GGACCTTCCTGGCCGTGAT
GGGAGATATATAAGGAGTC -> GGAGATATATAAGGAGTCT
GGGAGCTACTCACGCGTGA -> GGAGCTACTCACGCGTGAA
GGGAGGACGTGAACCACAA -> GGAGGACGTGAACCACAAG
GGGAGGTGGTCGGTTAAGT -> GGAGGTGGTCGGTTAAGTG
GGGAGTATAGTATCAGGTT -> GGAGTATAGTATCAGGTTT
GGGATGATAATTGGAGTGA -> GGATGATAATTGGAGTGAG
GGGATGGGAACAAGAAGAA -> GGATGGGAACAAGAAGAAC
GGGCAATTTGTCCTCCATC -> GGCAATTTGTCCTCCATCC
GGGCACCTTCCGTACCGAC -> GGCACCTTCCGTACCGACC
GGGCCATTTTTTTACGCTC -> GGCCATTTTTTTACGCTCG
GGGCGATGCTCCTTCGCGT -> GGCGATGCTCCTTCGCGTA
GGGCTAACGGAAGGTTTCT -> GGCTAACGGAAGGTTTCTT
GGGCTCCGCTCGCCCTCTG -> GGCTCCGCTCGCCCTCTGT
GGGCTGTTGCTTAGCTGCA -> GGCTGTTGCTTAGCTGCAG
GGGGAGATATATAAGGAGT -> GGGAGATATATAAGGAGTC
GGGGAGGTGGTCGGTTAAG -> GGGAGGTGGTCGGTTAAGT
GGGGATGATAATTGGAGTG -> GGGATGATAATTGGAGTGA
GGGGCCATTTTTTTACGCT -> GGGCCATTTTTTTACGCTC
GGGGGAGATATATAAGGAG -> GGGGAGATATATAAGGAGT
GGGGTAACACCGCCGACTG -> GGGTAACACCGCCGACTGC
GGGGTAGATTGCCGTAGGG -> GGGTAGATTGCCGTAGGGA
GGGTAACACCGCCGACTGC -> GGTAACACCGCCGACTGCA
GGGTAACCGGGTAGTGCAA -> GGTAACCGGGTAGTGCAAG
GGGTAATTGGACTCTACAA -> GGTAATTGGACTCTACAAC
GGGTACTAGTTTTACAATT -> GGTACTAGTTTTACAATTC
GGGTAGATTGCCGTAGGGA -> GGTAGATTGCCGTAGGGAG
GGGTAGTGCAAGTTCAATC -> GGTAGTGCAAGTTCAATCA
GGGTCCTCTACCTCAGCCT -> GGTCCTCTACCTCAGCCTG
GGGTCTAGACGGTATCAGC -> GGTCTAGACGGTATCAGCA
GGGTGCAAGTTTCTCATTC -> GGTGCAAGTTTCTCATTCT
GGGTGGAGGCACGGCGTCC -> GGTGGAGGCACGGCGTCCT
GGGTTCGTGGTGAAGCGGT -> GGTTCGTGGTGAAGCGGTT
GGTAACACCGCCGACTGCA -> GTAACACCGCCGACTGCAC
GGTAACCGGGTAGTGCAAG -> GTAACCGGGTAGTGCAAGT
GGTAAGATTCTGTTATGTG -> GTAAGATTCTGTTATGTGG
GGTAATTGGACTCTACAAC -> GTAATTGGACTCTACAACG
GGTACTAGTTTTACAATTC -> GTACTAGTTTTACAATTCG
GGTACTTTCGTGGCTCTAG -> GTACTTTCGTGGCTCTAGT
GGTAGAGGTTAGACGATTG -> GTAGAGGTTAGACGATTGA
GGTAGATTGCCGTAGGGAG -> GTAGATTGCCGTAGGGAGT
GGTAGGCCGGTTTTTAGTC -> GTAGGCCGGTTTTTAGTCT
GGTAGTGCAAGTTCAATCA -> GTAGTGCAAGTTCAATCAA
GGTATACGTCGGGTGCAAG -> GTATACGTCGGGTGCAAGT
GGTATCAACCAACCCATCA -> GTATCAACCAACCCATCAC
GGTATCAGCAGTCGGCATC -> GTATCAGCAGTCGGCATCC
GGTCAGCATAACAGGTCAT -> GTCAGCATAACAGGTCATC
GGTCAGCGGTGGGTCCTCT -> GTCAGCGGTGGGTCCTCTA
GGTCATCAAATTTAGCTGC -> GTCATCAAATTTAGCTGCA
GGTCCATTGACACTCGTTA -> GTCCATTGACACTCGTTAG
GGTCCGCCGGTAGGCCGGT -> GTCCGCCGGTAGGCCGGTT
GGTCCTCTACCTCAGCCTG -> GTCCTCTACCTCAGCCTGG
GGTCGGTTAAGTGAAAGTT -> GTCGGTTAAGTGAAAGTTC
GGTCTAGACGGTATCAGCA -> GTCTAGACGGTATCAGCAG
GGTGAAGCGGTTTATTAAG -> GTGAAGCGGTTTATTAAGA
GGTGCAAGTTTCTCATTCT -> GTGCAAGTTTCTCATTCTG
GGTGGAGGCACGGCGTCCT -> GTGGAGGCACGGCGTCCTA
GGTGGGTCCTCTACCTCAG -> GTGGGTCCTCTACCTCAGC
GGTGGTCGGTTAAGTGAAA -> GTGGTCGGTTAAGTGAAAG
GGTGTGAAAGGGGTAGATT -> GTGTGAAAGGGGTAGATTG
GGTGTTACTAGACTCCGAT -> GTGTTACTAGACTCCGATC
GGTTAAGTGAAAGTTCTTA -> GTTAAGTGAAAGTTCTTAG
GGTTAGACGATTGAAAGCA -> GTTAGACGATTGAAAGCAG
GGTTAGCTGCAGAGTTCAA -> GTTAGCTGCAGAGTTCAAT
GGTTCGCCCATGGTCAGCA -> GTTCGCCCATGGTCAGCAT
GGTTCGTGGTGAAGCGGTT -> GTTCGTGGTGAAGCGGTTT
GGTTGCGGCGTTGCACCAG -> GTTGCGGCGTTGCACCAGT
GGTTGGGATGGGAACAAGA -> GTTGGGATGGGAACAAGAA
GGTTTACTCATGTTACGCC -> GTTTACTCATGTTACGCCT
GGTTTATTAAGAGACAGGT -> GTTTATTAAGAGACAGGTT
GGTTTCTTTAGCTCATGTG -> GTTTCTTTAGCTCATGTGG
GGTTTGGTCAGCGGTGGGT -> GTTTGGTCAGCGGTGGGTC
GGTTTTTAGTCTGAGTAAG -> GTTTTTAGTCTGAGTAAGT
GTAAATGCTCGTCTCAATT -> TAAATGCTCGTCTCAATTC
GTAACACCGCCGACTGCAC -> TAACACCGCCGACTGCACA
GTAACCGGGTAGTGCAAGT -> TAACCGGGTAGTGCAAGTT
GTAACGCAGGGAGCTACTC -> TAACGCAGGGAGCTACTCA
GTAAGATTCTGTTATGTGG -> TAAGATTCTGTTATGTGGG
GTAAGTGCTGGCACGGGGA -> TAAGTGCTGGCACGGGGAT
GTAATTGGACTCTACAACG -> TAATTGGACTCTACAACGA
GTACATAATGGCATTGCAA -> TACATAATGGCATTGCAAG
GTACCGACCAGGGGTAACA -> TACCGACCAGGGGTAACAC
GTACGTGGGTAATTGGACT -> TACGTGGGTAATTGGACTC
GTACTAGTTTTACAATTCG -> TACTAGTTTTACAATTCGC
GTACTGCTGCATAGGAAAG -> TACTGCTGCATAGGAAAGA
GTACTTTCGTGGCTCTAGT -> TACTTTCGTGGCTCTAGTG
GTAGAGGTTAGACGATTGA -> TAGAGGTTAGACGATTGAA
GTAGATATGGAGCCTAAAC -> TAGATATGGAGCCTAAACA
GTAGATTGCCGTAGGGAGT -> TAGATTGCCGTAGGGAGTA
GTAGCCGCATATGGGTGGA -> TAGCCGCATATGGGTGGAG
GTAGGCCGGTTTTTAGTCT -> TAGGCCGGTTTTTAGTCTG
GTAGGGAGTATAGTATCAG -> TAGGGAGTATAGTATCAGG
GTAGGGTTCGTGGTGAAGC -> TAGGGTTCGTGGTGAAGCG
GTAGGTCCATTGACACTCG -> TAGGTCCATTGACACTCGT
GTAGTGCAAGTTCAATCAA -> TAGTGCAAGTTCAATCAAC
GTATAAGCAGCTAGTAGAT -> TATAAGCAGCTAGTAGATA
GTATACGTCGGGTGCAAGT -> TATACGTCGGGTGCAAGTT
GTATAGTATCAGGTTTACT -> TATAGTATCAGGTTTACTC
GTATCAACCAACCCATCAC -> TATCAACCAACCCATCACC
GTATCAGCAGTCGGCATCC -> TATCAGCAGTCGGCATCCG
GTATCAGGTTTACTCATGT -> TATCAGGTTTACTCATGTT
GTATCGGCGGGCGATGCTC -> TATCGGCGGGCGATGCTCC
GTATGGGCACCTTCCGTAC -> TATGGGCACCTTCCGTACC
GTATGGTTAGCTGCAGAGT -> TATGGTTAGCTGCAGAGTT
GTCACTCATCGTGGATGTG -> TCACTCATCGTGGATGTGG
GTCAGCATAACAGGTCATC -> TCAGCATAACAGGTCATCA
GTCAGCGGCGCAGAGTGCG -> TCAGCGGCGCAGAGTGCGA
GTCAGCGGTGGGTCCTCTA -> TCAGCGGTGGGTCCTCTAC
GTCATCAAATTTAGCTGCA -> TCATCAAATTTAGCTGCAG
GTCATCATAGGAAAGAAAC -> TCATCATAGGAAAGAAACT
GTCATGAGTTATGGACGGG -> TCATGAGTTATGGACGGGA
GTCCAAATAGCTGTCATCA -> TCCAAATAGCTGTCATCAT
GTCCATGCGAGTTGTGGGG -> TCCATGCGAGTTGTGGGGA
GTCCATTGACACTCGTTAG -> TCCATTGACACTCGTTAGG
GTCCGCCGGTAGGCCGGTT -> TCCGCCGGTAGGCCGGTTT
GTCCTACTTCTACAAAACG -> TCCTACTTCTACAAAACGT
GTCCTCCATCCTAACTATT -> TCCTCCATCCTAACTATTG
GTCCTCTACCTCAGCCTGG -> TCCTCTACCTCAGCCTGGA
GTCGGCATCCGTTAGCCTA -> TCGGCATCCGTTAGCCTAA
GTCGGGTGCAAGTTTCTCA -> TCGGGTGCAAGTTTCTCAT
GTCGGTTAAGTGAAAGTTC -> TCGGTTAAGTGAAAGTTCT
GTCGTGCTCCACGGGGCCA -> TCGTGCTCCACGGGGCCAT
GTCTAGACGGTATCAGCAG -> TCTAGACGGTATCAGCAGT
GTCTAGCAACCAAGAAAAC -> TCTAGCAACCAAGAAAACC
GTCTATGGCACACGCAATG -> TCTATGGCACACGCAATGA
GTCTCAATTCCTCAAGTGG -> TCTCAATTCCTCAAGTGGT
GTCTGAACGACCGGCGTAG -> TCTGAACGACCGGCGTAGG
GTCTGAGTAAGTGCTGGCA -> TCTGAGTAAGTGCTGGCAC
GTCTGCTCCCACCGGATCC -> TCTGCTCCCACCGGATCCT
GTGAAAGGGGTAGATTGCC -> TGAAAGGGGTAGATTGCCG
GTGAAAGTTCTTAGCAGGA -> TGAAAGTTCTTAGCAGGAA
GTGAAATTAGCTGCAGAGT -> TGAAATTAGCTGCAGAGTT
GTGAACATAAGCCGATTAC -> TGAACATAAGCCGATTACT
GTGAACCACAAGGCTCTTA -> TGAACCACAAGGCTCTTAT
GTGAAGCGGTTTATTAAGA -> TGAAGCGGTTTATTAAGAG
GTGAATGCACGCGACCTAA -> TGAATGCACGCGACCTAAG
GTGACACAGTTGGTTCGCC -> TGACACAGTTGGTTCGCCC
GTGACGGGTCTAGACGGTA -> TGACGGGTCTAGACGGTAT
GTGAGAATTCGCGTCCATG -> TGAGAATTCGCGTCCATGC
GTGAGAGATTTGACCACCC -> TGAGAGATTTGACCACCCA
GTGAGATCACGGAACGATG -> TGAGATCACGGAACGATGA
GTGATACCGCGGAGGTAGA -> TGATACCGCGGAGGTAGAG
GTGATACGGAGTGGTATCA -> TGATACGGAGTGGTATCAA
GTGATCACGGGCTGTTGCT -> TGATCACGGGCTGTTGCTT
GTGCAAGTTCAATCAACGA -> TGCAAGTTCAATCAACGAG
GTGCAAGTTTCTCATTCTG -> TGCAAGTTTCTCATTCTGT
GTGCGACTGGCGTTCATGG -> TGCGACTGGCGTTCATGGT
GTGCTACAGAAACCGAGTT -> TGCTACAGAAACCGAGTTC
GTGCTCCACGGGGCCATTT -> TGCTCCACGGGGCCATTTT
GTGCTGGCACGGGGATGAT -> TGCTGGCACGGGGATGATA
GTGGACAAATCGACAATTT -> TGGACAAATCGACAATTTT
GTGGAGGCACGGCGTCCTA -> TGGAGGCACGGCGTCCTAC
GTGGATGTGGATGTTTCGA -> TGGATGTGGATGTTTCGAT
GTGGATGTTTCGATAGCGC -> TGGATGTTTCGATAGCGCC
GTGGCGCTGAGTTGAAGCC -> TGGCGCTGAGTTGAAGCCT
GTGGCTCTAGTGTACGTGG -> TGGCTCTAGTGTACGTGGG
GTGGGGAGGTGGTCGGTTA -> TGGGGAGGTGGTCGGTTAA
GTGGGTAATTGGACTCTAC -> TGGGTAATTGGACTCTACA
GTGGGTACTAGTTTTACAA -> TGGGTACTAGTTTTACAAT
GTGGGTCCTCTACCTCAGC -> TGGGTCCTCTACCTCAGCC
GTGGTACTTTCGTGGCTCT -> TGGTACTTTCGTGGCTCTA
GTGGTATCAACCAACCCAT -> TGGTATCAACCAACCCATC
GTGGTCGGTTAAGTGAAAG -> TGGTCGGTTAAGTGAAAGT
GTGGTGAAGCGGTTTATTA -> TGGTGAAGCGGTTTATTAA
GTGTACGTGGGTAATTGGA -> TGTACGTGGGTAATTGGAC
GTGTATGGGCACCTTCCGT -> TGTATGGGCACCTTCCGTA
GTGTGAAAGGGGTAGATTG -> TGTGAAAGGGGTAGATTGC
GTGTTACTAGACTCCGATC -> TGTTACTAGACTCCGATCA
GTTAAGTGAAAGTTCTTAG -> TTAAGTGAAAGTTCTTAGC
GTTACAACCTCCGCGCGAT -> TTACAACCTCCGCGCGATG
GTTACGCCTTCTATAAAGC -> TTACGCCTTCTATAAAGCC
GTTACTAGACTCCGATCAG -> TTACTAGACTCCGATCAGT
GTTAGAAGTTGGGACCTTC -> TTAGAAGTTGGGACCTTCC
GTTAGACGATTGAAAGCAG -> TTAGACGATTGAAAGCAGT
GTTAGCCTAAGTCATGAGT -> TTAGCCTAAGTCATGAGTT
GTTAGCTGCAGAGTTCAAT -> TTAGCTGCAGAGTTCAATG
GTTAGGGAAACCTGCTAGT -> TTAGGGAAACCTGCTAGTT
GTTATAAGACCTTATGAGC -> TTATAAGACCTTATGAGCG
GTTATGGACGGGAGGACGT -> TTATGGACGGGAGGACGTG
GTTATGTGGGTACTAGTTT -> TTATGTGGGTACTAGTTTT
GTTCAACGATTTCCGAATA -> TTCAACGATTTCCGAATAA
GTTCAATAAAAGGTTGCGG -> TTCAATAAAAGGTTGCGGC
GTTCAATCAACGAGCCAGG -> TTCAATCAACGAGCCAGGC
GTTCAATCAGACTGAAACG -> TTCAATCAGACTGAAACGC
GTTCAATGGCTAGCTTCTG -> TTCAATGGCTAGCTTCTGC
GTTCAATTTCTCACGGATG -> TTCAATTTCTCACGGATGC
GTTCACCATTCATACGTGA -> TTCACCATTCATACGTGAA
GTTCATGGTGTTACTAGAC -> TTCATGGTGTTACTAGACT
GTTCCCTCATTAGGAGTAG -> TTCCCTCATTAGGAGTAGC
GTTCGCCCATGGTCAGCAT -> TTCGCCCATGGTCAGCATA
GTTCGCGATTGCAAGCTAA -> TTCGCGATTGCAAGCTAAA
GTTCGTGGTGAAGCGGTTT -> TTCGTGGTGAAGCGGTTTA
GTTCTTAGCAGGAATACGC -> TTCTTAGCAGGAATACGCT
GTTGAAGCCTTCGACCAAT -> TTGAAGCCTTCGACCAATA
GTTGCACCAGTTTGATACC -> TTGCACCAGTTTGATACCA
GTTGCACCAGTTTGATAGC -> TTGCACCAGTTTGATAGCG
GTTGCACCAGTTTGATAGG -> TTGCACCAGTTTGATAGGC
GTTGCACCAGTTTGATATC -> TTGCACCAGTTTGATATCA
GTTGCGGCGTTGCACCAGT -> TTGCGGCGTTGCACCAGTT
GTTGCTTAGCTGCAGAGTT -> TTGCTTAGCTGCAGAGTTC
GTTGGGACCTTCCTGGCCG -> TTGGGACCTTCCTGGCCGT
GTTGGGATGGGAACAAGAA -> TTGGGATGGGAACAAGAAG
GTTGGTTCGCCCATGGTCA -> TTGGTTCGCCCATGGTCAG
GTTGTGGGGAGGTGGTCGG -> TTGTGGGGAGGTGGTCGGT
GTTTACTCATGTTACGCCT -> TTTACTCATGTTACGCCTT
GTTTATTAAGAGACAGGTT -> TTTATTAAGAGACAGGTTT
GTTTCGATAGCGCCCTGGC -> TTTCGATAGCGCCCTGGCA
GTTTCTCATTCTGTGATAC -> TTTCTCATTCTGTGATACC
GTTTCTTTAGCTCATGTGG -> TTTCTTTAGCTCATGTGGC
GTTTGAAAGGGGGAGATAT -> TTTGAAAGGGGGAGATATA
GTTTGATACCACTTTCCGC -> TTTGATACCACTTTCCGCA
GTTTGATAGCGCCAAACAG -> TTTGATAGCGCCAAACAGA
GTTTGATAGGCAGGGCAAT -> TTTGATAGGCAGGGCAATT
GTTTGATATCATTGTGACG -> TTTGATATCATTGTGACGG
GTTTGGTCAGCGGTGGGTC -> TTTGGTCAGCGGTGGGTCC
GTTTGTTCCCTCATTAGGA -> TTTGTTCCCTCATTAGGAG
GTTTTACAATTCGCAGACA -> TTTTACAATTCGCAGACAC
GTTTTCGGGCTAACGGAAG -> TTTTCGGGCTAACGGAAGG
GTTTTTAGTCTGAGTAAGT -> TTTTTAGTCTGAGTAAGTG
GTTTTTCCCGCGCTTGTGT -> TTTTTCCCGCGCTTGTGTA
TAAAAATGGTAAGATTCTG -> AAAAATGGTAAGATTCTGT
TAAAAGGTTGCGGCGTTGC -> AAAAGGTTGCGGCGTTGCA
TAAACAATCCGCTCTAGGA -> AAACAATCCGCTCTAGGAA
TAAACCCATATTCCTTTCG -> AAACCCATATTCCTTTCGA
TAAAGCCCCCGCGGCCCAC -> AAAGCCCCCGCGGCCCACT
TAAATGCTCGTCTCAATTC -> AAATGCTCGTCTCAATTCC
TAACACCGCCGACTGCACA -> AACACCGCCGACTGCACAC
TAACAGGTCATCAAATTTA -> AACAGGTCATCAAATTTAG
TAACCGGGTAGTGCAAGTT -> AACCGGGTAGTGCAAGTTC
TAACCTAGCTTCTCGTGCT -> AACCTAGCTTCTCGTGCTA
TAACGCAGGGAGCTACTCA -> AACGCAGGGAGCTACTCAC
TAACGGAAGGTTTCTTTAG -> AACGGAAGGTTTCTTTAGC
TAACTATTGACAAATTGTC -> AACTATTGACAAATTGTCT
TAAGACCTTATGAGCGTAA -> AAGACCTTATGAGCGTAAC
TAAGAGACAGGTTTGGTCA -> AAGAGACAGGTTTGGTCAG
TAAGATCCGCCAAGGTCCG -> AAGATCCGCCAAGGTCCGC
TAAGATTCTGTTATGTGGG -> AAGATTCTGTTATGTGGGT
TAAGCAAGGAGACAAAGTG -> AAGCAAGGAGACAAAGTGG
TAAGCAGCTAGTAGATATG -> AAGCAGCTAGTAGATATGG
TAAGCCGATTACTCCCTCG -> AAGCCGATTACTCCCTCGG
TAAGCGTAGGTCCATTGAC -> AAGCGTAGGTCCATTGACA
TAAGCTCCAAATAGCCCTA -> AAGCTCCAAATAGCCCTAC
TAAGGAGTCTATGGCACAC -> AAGGAGTCTATGGCACACG
TAAGTCATGAGTTATGGAC -> AAGTCATGAGTTATGGACG
TAAGTGAAAGTTCTTAGCA -> AAGTGAAAGTTCTTAGCAG
TAAGTGCTGGCACGGGGAT -> AAGTGCTGGCACGGGGATG
TAATAGTGATCACGGGCTG -> AATAGTGATCACGGGCTGT
TAATGGCATTGCAAGGCAG -> AATGGCATTGCAAGGCAGG
TAATTGGACTCTACAACGA -> AATTGGACTCTACAACGAT
TAATTGGAGTGAGAGATTT -> AATTGGAGTGAGAGATTTG
TACAAAACGTTAGAAGTTG -> ACAAAACGTTAGAAGTTGG
TACAACCTCCGCGCGATGT -> ACAACCTCCGCGCGATGTG
TACAACGATCGTTCACCAT -> ACAACGATCGTTCACCATT
TACAATTCGCAGACACAGC -> ACAATTCGCAGACACAGCG
TACAGAAACCGAGTTCGCG -> ACAGAAACCGAGTTCGCGA
TACATAATGGCATTGCAAG -> ACATAATGGCATTGCAAGG
TACCACTTTCCGCATAAGC -> ACCACTTTCCGCATAAGCA
TACCGACCAGGGGTAACAC -> ACCGACCAGGGGTAACACC
TACCGCACCCTCGCGGTGT -> ACCGCACCCTCGCGGTGTG
TACCGCGGAGGTAGAGGTT -> ACCGCGGAGGTAGAGGTTA
TACCTCAGCCTGGACAGAG -> ACCTCAGCCTGGACAGAGA
TACGAGATGAAGCGGGCTC -> ACGAGATGAAGCGGGCTCC
TACGCCTTCTATAAAGCCC -> ACGCCTTCTATAAAGCCCC
TACGCTCACCTGTGACACA -> ACGCTCACCTGTGACACAG
TACGCTCGTTTGTTCCCTC -> ACGCTCGTTTGTTCCCTCA
TACGGAGTGGTATCAACCA -> ACGGAGTGGTATCAACCAA
TACGTCGGGTGCAAGTTTC -> ACGTCGGGTGCAAGTTTCT
TACGTGAATGCACGCGACC -> ACGTGAATGCACGCGACCT
TACGTGGGTAATTGGACTC -> ACGTGGGTAATTGGACTCT
TACTAAAAATGGTAAGATT -> ACTAAAAATGGTAAGATTC
TACTAGACTCCGATCAGTA -> ACTAGACTCCGATCAGTAA
TACTAGTTTTACAATTCGC -> ACTAGTTTTACAATTCGCA
TACTCACGCGTGAAATTAG -> ACTCACGCGTGAAATTAGC
TACTCATGTTACGCCTTCT -> ACTCATGTTACGCCTTCTA
TACTCCCTCGGGTAACCGG -> ACTCCCTCGGGTAACCGGG
TACTGCTGCATAGGAAAGA -> ACTGCTGCATAGGAAAGAA
TACTGGCTACTAAAAATGG -> ACTGGCTACTAAAAATGGT
TACTTCTACAAAACGTTAG -> ACTTCTACAAAACGTTAGA
TACTTTCGTGGCTCTAGTG -> ACTTTCGTGGCTCTAGTGT
TAGAAGTTGGGACCTTCCT -> AGAAGTTGGGACCTTCCTG
TAGACGATTGAAAGCAGTG -> AGACGATTGAAAGCAGTGA
TAGACGGTATCAGCAGTCG -> AGACGGTATCAGCAGTCGG
TAGACTCCGATCAGTAAAT -> AGACTCCGATCAGTAAATG
TAGAGGTTAGACGATTGAA -> AGAGGTTAGACGATTGAAA
TAGATATGGAGCCTAAACA -> AGATATGGAGCCTAAACAA
TAGATTGCCGTAGGGAGTA -> AGATTGCCGTAGGGAGTAT
TAGCAACCAAGAAAACCTG -> AGCAACCAAGAAAACCTGC
TAGCAGGAATACGCTCACC -> AGCAGGAATACGCTCACCT
TAGCATCTACTGGCTACTA -> AGCATCTACTGGCTACTAA
TAGCCCTACGAGATGAAGC -> AGCCCTACGAGATGAAGCG
TAGCCGAGTACTGCTGCAT -> AGCCGAGTACTGCTGCATA
TAGCCGCATATGGGTGGAG -> AGCCGCATATGGGTGGAGG
TAGCCTAAGTCATGAGTTA -> AGCCTAAGTCATGAGTTAT
TAGCGCCAAACAGAAGCTT -> AGCGCCAAACAGAAGCTTA
TAGCGCCCTGGCACTGGAC -> AGCGCCCTGGCACTGGACC
TAGCGCTGGCCGATTGCGT -> AGCGCTGGCCGATTGCGTC
TAGCTCATGTGGCGCTGAG -> AGCTCATGTGGCGCTGAGT
TAGCTGAAATCGCGCTCGA -> AGCTGAAATCGCGCTCGAG
TAGCTGCAGAGTTCAATAA -> AGCTGCAGAGTTCAATAAA
TAGCTGCAGAGTTCAATCA -> AGCTGCAGAGTTCAATCAG
TAGCTGCAGAGTTCAATGG -> AGCTGCAGAGTTCAATGGC
TAGCTGCAGAGTTCAATTT -> AGCTGCAGAGTTCAATTTC
TAGCTGTCATCATAGGAAA -> AGCTGTCATCATAGGAAAG
TAGCTTCTCGTGCTACAGA -> AGCTTCTCGTGCTACAGAA
TAGCTTCTGCGTTGCACCA -> AGCTTCTGCGTTGCACCAG
TAGGAAAACTTTAAGCGTA -> AGGAAAACTTTAAGCGTAG
TAGGAAAGAAACTAGCATC -> AGGAAAGAAACTAGCATCT
TAGGAAAGAAAGTCAGCGG -> AGGAAAGAAAGTCAGCGGC
TAGGAGTAGCCGCATATGG -> AGGAGTAGCCGCATATGGG
TAGGCAGGGCAATTTGTCC -> AGGCAGGGCAATTTGTCCT
TAGGCCGGTTTTTAGTCTG -> AGGCCGGTTTTTAGTCTGA
TAGGCGAAAAGTATGGTTA -> AGGCGAAAAGTATGGTTAG
TAGGGAAACCTGCTAGTTA -> AGGGAAACCTGCTAGTTAT
TAGGGAGTATAGTATCAGG -> AGGGAGTATAGTATCAGGT
TAGGGTTCGTGGTGAAGCG -> AGGGTTCGTGGTGAAGCGG
TAGGTCCATTGACACTCGT -> AGGTCCATTGACACTCGTT
TAGTAGATATGGAGCCTAA -> AGTAGATATGGAGCCTAAA
TAGTATCAGGTTTACTCAT -> AGTATCAGGTTTACTCATG
TAGTCTGAGTAAGTGCTGG -> AGTCTGAGTAAGTGCTGGC
TAGTGATCACGGGCTGTTG -> AGTGATCACGGGCTGTTGC
TAGTGCAAGTTCAATCAAC -> AGTGCAAGTTCAATCAACG
TAGTGTACGTGGGTAATTG -> AGTGTACGTGGGTAATTGG
TAGTTATAAGACCTTATGA -> AGTTATAAGACCTTATGAG
TAGTTTTACAATTCGCAGA -> AGTTTTACAATTCGCAGAC
TATAAAGCCCCCGCGGCCC -> ATAAAGCCCCCGCGGCCCA
TATAAGACCTTATGAGCGT -> ATAAGACCTTATGAGCGTA
TATAAGCAGCTAGTAGATA -> ATAAGCAGCTAGTAGATAT
TATAAGGAGTCTATGGCAC -> ATAAGGAGTCTATGGCACA
TATACGTCGGGTGCAAGTT -> ATACGTCGGGTGCAAGTTT
TATAGTATCAGGTTTACTC -> ATAGTATCAGGTTTACTCA
TATATAAGGAGTCTATGGC -> ATATAAGGAGTCTATGGCA
TATCAACCAACCCATCACC -> ATCAACCAACCCATCACCT
TATCAGCAGTCGGCATCCG -> ATCAGCAGTCGGCATCCGT
TATCAGGTTTACTCATGTT -> ATCAGGTTTACTCATGTTA
TATCATTGTGACGGGTCTA -> ATCATTGTGACGGGTCTAG
TATCCAGTTACAACCTCCG -> ATCCAGTTACAACCTCCGC
TATCGGCGGGCGATGCTCC -> ATCGGCGGGCGATGCTCCT
TATGAGCGTAACGCAGGGA -> ATGAGCGTAACGCAGGGAG
TATGGACGGGAGGACGTGA -> ATGGACGGGAGGACGTGAA
TATGGAGCCTAAACAATCC -> ATGGAGCCTAAACAATCCG
TATGGCACACGCAATGAGG -> ATGGCACACGCAATGAGGC
TATGGGCACCTTCCGTACC -> ATGGGCACCTTCCGTACCG
TATGGGTGGAGGCACGGCG -> ATGGGTGGAGGCACGGCGT
TATGGTTAGCTGCAGAGTT -> ATGGTTAGCTGCAGAGTTC
TATGTATAAGCAGCTAGTA -> ATGTATAAGCAGCTAGTAG
TATGTCTAGCAACCAAGAA -> ATGTCTAGCAACCAAGAAA
TATGTGGGTACTAGTTTTA -> ATGTGGGTACTAGTTTTAC
TATTAAGAGACAGGTTTGG -> ATTAAGAGACAGGTTTGGT
TATTCCTTTCGAGGCATTA -> ATTCCTTTCGAGGCATTAC
TATTGACAAATTGTCTGAA -> ATTGACAAATTGTCTGAAC
TCAAATTTAGCTGCAGAGT -> CAAATTTAGCTGCAGAGTT
TCAACCAACCCATCACCTC -> CAACCAACCCATCACCTCC
TCAACGAGCCAGGCTAGCC -> CAACGAGCCAGGCTAGCCG
TCAACGATTTCCGAATAAT -> CAACGATTTCCGAATAATA
TCAAGTGGTACTTTCGTGG -> CAAGTGGTACTTTCGTGGC
TCAATAAAAGGTTGCGGCG -> CAATAAAAGGTTGCGGCGT
TCAATCAACGAGCCAGGCT -> CAATCAACGAGCCAGGCTA
TCAATCAGACTGAAACGCG -> CAATCAGACTGAAACGCGT
TCAATGGCTAGCTTCTGCG -> CAATGGCTAGCTTCTGCGT
TCAATTCCTCAAGTGGTAC -> CAATTCCTCAAGTGGTACT
TCAATTTCTCACGGATGCG -> CAATTTCTCACGGATGCGT
TCACCATTCATACGTGAAT -> CACCATTCATACGTGAATG
TCACCTCCACGAACATGGC -> CACCTCCACGAACATGGCA
TCACCTGTGACACAGTTGG -> CACCTGTGACACAGTTGGT
TCACGCGTGAAATTAGCTG -> CACGCGTGAAATTAGCTGC
TCACGGAACGATGACAATG -> CACGGAACGATGACAATGT
TCACGGATGCGTTGCACCA -> CACGGATGCGTTGCACCAG
TCACGGGCTGTTGCTTAGC -> CACGGGCTGTTGCTTAGCT
TCACTCATCGTGGATGTGG -> CACTCATCGTGGATGTGGA
TCAGACTGAAACGCGTTGC -> CAGACTGAAACGCGTTGCA
TCAGCAGTCGGCATCCGTT -> CAGCAGTCGGCATCCGTTA
TCAGCATAACAGGTCATCA -> CAGCATAACAGGTCATCAA
TCAGCCTGGACAGAGAAAC -> CAGCCTGGACAGAGAAACC
TCAGCGGCGCAGAGTGCGA -> CAGCGGCGCAGAGTGCGAC
TCAGCGGTGGGTCCTCTAC -> CAGCGGTGGGTCCTCTACC
TCAGGTTTACTCATGTTAC -> CAGGTTTACTCATGTTACG
TCAGTAAATGCTCGTCTCA -> CAGTAAATGCTCGTCTCAA
TCATACGTGAATGCACGCG -> CATACGTGAATGCACGCGA
TCATAGGAAAGAAACTAGC -> CATAGGAAAGAAACTAGCA
TCATCAAATTTAGCTGCAG -> CATCAAATTTAGCTGCAGA
TCATCATAGGAAAGAAACT -> CATCATAGGAAAGAAACTA
TCATCGTGGATGTGGATGT -> CATCGTGGATGTGGATGTT
TCATGAGTTATGGACGGGA -> CATGAGTTATGGACGGGAG
TCATGGTGTTACTAGACTC -> CATGGTGTTACTAGACTCC
TCATGTGGCGCTGAGTTGA -> CATGTGGCGCTGAGTTGAA
TCATGTTACGCCTTCTATA -> CATGTTACGCCTTCTATAA
TCATTAGGAGTAGCCGCAT -> CATTAGGAGTAGCCGCATA
TCATTCTGTGATACCGCGG -> CATTCTGTGATACCGCGGA
TCATTGTGACGGGTCTAGA -> CATTGTGACGGGTCTAGAC
TCCAAATAGCCCTACGAGA -> CCAAATAGCCCTACGAGAT
TCCAAATAGCTGTCATCAT -> CCAAATAGCTGTCATCATA
TCCACGAACATGGCAACTC -> CCACGAACATGGCAACTCA
TCCACGGGGCCATTTTTTT -> CCACGGGGCCATTTTTTTA
TCCAGTTACAACCTCCGCG -> CCAGTTACAACCTCCGCGC
TCCATCCTAACTATTGACA -> CCATCCTAACTATTGACAA
TCCATGCGAGTTGTGGGGA -> CCATGCGAGTTGTGGGGAG
TCCATTGACACTCGTTAGG -> CCATTGACACTCGTTAGGG
TCCCACCGGATCCTGGTAT -> CCCACCGGATCCTGGTATA
TCCCGCGCTTGTGTATGGG -> CCCGCGCTTGTGTATGGGC
TCCCTCATTAGGAGTAGCC -> CCCTCATTAGGAGTAGCCG
TCCCTCGGGTAACCGGGTA -> CCCTCGGGTAACCGGGTAG
TCCGAATAATAGTGATCAC -> CCGAATAATAGTGATCACG
TCCGATCAGTAAATGCTCG -> CCGATCAGTAAATGCTCGT
TCCGCATAAGCAAGGAGAC -> CCGCATAAGCAAGGAGACA
TCCGCCAAGGTCCGCCGGT -> CCGCCAAGGTCCGCCGGTA
TCCGCCGGTAGGCCGGTTT -> CCGCCGGTAGGCCGGTTTT
TCCGCGCGATGTGAACATA -> CCGCGCGATGTGAACATAA
TCCGCTCGCCCTCTGTTTT -> CCGCTCGCCCTCTGTTTTC
TCCGCTCTAGGAAAACTTT -> CCGCTCTAGGAAAACTTTA
TCCGTACCGACCAGGGGTA -> CCGTACCGACCAGGGGTAA
TCCGTTAGCCTAAGTCATG -> CCGTTAGCCTAAGTCATGA
TCCGTTTGAAAGGGGGAGA -> CCGTTTGAAAGGGGGAGAT
TCCTAACTATTGACAAATT -> CCTAACTATTGACAAATTG
TCCTACTTCTACAAAACGT -> CCTACTTCTACAAAACGTT
TCCTCAAGTGGTACTTTCG -> CCTCAAGTGGTACTTTCGT
TCCTCCATCCTAACTATTG -> CCTCCATCCTAACTATTGA
TCCTCTACCTCAGCCTGGA -> CCTCTACCTCAGCCTGGAC
TCCTGGCCGTGATACGGAG -> CCTGGCCGTGATACGGAGT
TCCTGGTATACGTCGGGTG -> CCTGGTATACGTCGGGTGC
TCCTTCGCGTACATAATGG -> CCTTCGCGTACATAATGGC
TCCTTTCGAGGCATTACCG -> CCTTTCGAGGCATTACCGC
TCGACAATTTTCGGACGGA -> CGACAATTTTCGGACGGAT
TCGACCAATAACCTAGCTT -> CGACCAATAACCTAGCTTC
TCGAGGCATTACCGCACCC -> CGAGGCATTACCGCACCCT
TCGAGTCTGCTCCCACCGG -> CGAGTCTGCTCCCACCGGA
TCGATAGCGCCCTGGCACT -> CGATAGCGCCCTGGCACTG
TCGCAGACACAGCGTCGTG -> CGCAGACACAGCGTCGTGC
TCGCCCATGGTCAGCATAA -> CGCCCATGGTCAGCATAAC
TCGCCCTCTGTTTTCGGGC -> CGCCCTCTGTTTTCGGGCT
TCGCGATTGCAAGCTAAAC -> CGCGATTGCAAGCTAAACC
TCGCGCTCGAGTCTGCTCC -> CGCGCTCGAGTCTGCTCCC
TCGCGGTGTGAAAGGGGTA -> CGCGGTGTGAAAGGGGTAG
TCGCGTACATAATGGCATT -> CGCGTACATAATGGCATTG
TCGCGTCCATGCGAGTTGT -> CGCGTCCATGCGAGTTGTG
TCGGACGGATTAGGCGAAA -> CGGACGGATTAGGCGAAAA
TCGGCATCCGTTAGCCTAA -> CGGCATCCGTTAGCCTAAG
TCGGCGGGCGATGCTCCTT -> CGGCGGGCGATGCTCCTTC
TCGGGCTAACGGAAGGTTT -> CGGGCTAACGGAAGGTTTC
TCGGGTAACCGGGTAGTGC -> CGGGTAACCGGGTAGTGCA
TCGGGTGCAAGTTTCTCAT -> CGGGTGCAAGTTTCTCATT
TCGGTTAAGTGAAAGTTCT -> CGGTTAAGTGAAAGTTCTT
TCGTCTCAATTCCTCAAGT -> CGTCTCAATTCCTCAAGTG
TCGTGCTACAGAAACCGAG -> CGTGCTACAGAAACCGAGT
TCGTGCTCCACGGGGCCAT -> CGTGCTCCACGGGGCCATT
TCGTGGATGTGGATGTTTC -> CGTGGATGTGGATGTTTCG
TCGTGGCTCTAGTGTACGT -> CGTGGCTCTAGTGTACGTG
TCGTGGTGAAGCGGTTTAT -> CGTGGTGAAGCGGTTTATT
TCGTTAGGGAAACCTGCTA -> CGTTAGGGAAACCTGCTAG
TCGTTCACCATTCATACGT -> CGTTCACCATTCATACGTG
TCGTTTGTTCCCTCATTAG -> CGTTTGTTCCCTCATTAGG
TCTACAAAACGTTAGAAGT -> CTACAAAACGTTAGAAGTT
TCTACAACGATCGTTCACC -> CTACAACGATCGTTCACCA
TCTACCTCAGCCTGGACAG -> CTACCTCAGCCTGGACAGA
TCTACTGGCTACTAAAAAT -> CTACTGGCTACTAAAAATG
TCTAGACGGTATCAGCAGT -> CTAGACGGTATCAGCAGTC
TCTAGCAACCAAGAAAACC -> CTAGCAACCAAGAAAACCT
TCTAGGAAAACTTTAAGCG -> CTAGGAAAACTTTAAGCGT
TCTAGTGTACGTGGGTAAT -> CTAGTGTACGTGGGTAATT
TCTATAAAGCCCCCGCGGC -> CTATAAAGCCCCCGCGGCC
TCTATGGCACACGCAATGA -> CTATGGCACACGCAATGAG
TCTCAATTCCTCAAGTGGT -> CTCAATTCCTCAAGTGGTA
TCTCACGGATGCGTTGCAC -> CTCACGGATGCGTTGCACC
TCTCATTCTGTGATACCGC -> CTCATTCTGTGATACCGCG
TCTCGTGCTACAGAAACCG -> CTCGTGCTACAGAAACCGA
TCTGAACGACCGGCGTAGG -> CTGAACGACCGGCGTAGGG
TCTGAGTAAGTGCTGGCAC -> CTGAGTAAGTGCTGGCACG
TCTGCGTTGCACCAGTTTG -> CTGCGTTGCACCAGTTTGA
TCTGCTCCCACCGGATCCT -> CTGCTCCCACCGGATCCTG
TCTGTGATACCGCGGAGGT -> CTGTGATACCGCGGAGGTA
TCTGTTATGTGGGTACTAG -> CTGTTATGTGGGTACTAGT
TCTGTTTTCGGGCTAACGG -> CTGTTTTCGGGCTAACGGA
TCTTAGCAGGAATACGCTC -> CTTAGCAGGAATACGCTCA
TCTTAGCTGAAATCGCGCT -> CTTAGCTGAAATCGCGCTC
TCTTATGTATAAGCAGCTA -> CTTATGTATAAGCAGCTAG
TCTTTAGCTCATGTGGCGC -> CTTTAGCTCATGTGGCGCT
TGAAAAGTTTTTCCCGCGC -> GAAAAGTTTTTCCCGCGCT
TGAAACGCGTTGCACCAGT -> GAAACGCGTTGCACCAGTT
TGAAAGCAGTGAGATCACG -> GAAAGCAGTGAGATCACGG
TGAAAGGGGGAGATATATA -> GAAAGGGGGAGATATATAA
TGAAAGGGGTAGATTGCCG -> GAAAGGGGTAGATTGCCGT
TGAAAGTTCTTAGCAGGAA -> GAAAGTTCTTAGCAGGAAT
TGAAATCGCGCTCGAGTCT -> GAAATCGCGCTCGAGTCTG
TGAAATTAGCTGCAGAGTT -> GAAATTAGCTGCAGAGTTC
TGAACATAAGCCGATTACT -> GAACATAAGCCGATTACTC
TGAACCACAAGGCTCTTAT -> GAACCACAAGGCTCTTATG
TGAACGACCGGCGTAGGGT -> GAACGACCGGCGTAGGGTT
TGAAGCCTTCGACCAATAA -> GAAGCCTTCGACCAATAAC
TGAAGCGGGCTCCGCTCGC -> GAAGCGGGCTCCGCTCGCC
TGAAGCGGTTTATTAAGAG -> GAAGCGGTTTATTAAGAGA
TGAATGCACGCGACCTAAG -> GAATGCACGCGACCTAAGA
TGACAAATTGTCTGAACGA -> GACAAATTGTCTGAACGAC
TGACAATGTCACTCATCGT -> GACAATGTCACTCATCGTG
TGACACAGTTGGTTCGCCC -> GACACAGTTGGTTCGCCCA
TGACACTCGTTAGGGAAAC -> GACACTCGTTAGGGAAACC
TGACCACCCAACAGGCGTG -> GACCACCCAACAGGCGTGA
TGACGGGTCTAGACGGTAT -> GACGGGTCTAGACGGTATC
TGAGAATTCGCGTCCATGC -> GAGAATTCGCGTCCATGCG
TGAGAGATTTGACCACCCA -> GAGAGATTTGACCACCCAA
TGAGATCACGGAACGATGA -> GAGATCACGGAACGATGAC
TGAGCGTAACGCAGGGAGC -> GAGCGTAACGCAGGGAGCT
TGAGGCAAAGACCCGGTTG -> GAGGCAAAGACCCGGTTGG
TGAGTAAGTGCTGGCACGG -> GAGTAAGTGCTGGCACGGG
TGAGTTATGGACGGGAGGA -> GAGTTATGGACGGGAGGAC
TGAGTTGAAGCCTTCGACC -> GAGTTGAAGCCTTCGACCA
TGATAATTGGAGTGAGAGA -> GATAATTGGAGTGAGAGAT
TGATACCACTTTCCGCATA -> GATACCACTTTCCGCATAA
TGATACCGCGGAGGTAGAG -> GATACCGCGGAGGTAGAGG
TGATACGGAGTGGTATCAA -> GATACGGAGTGGTATCAAC
TGATAGCGCCAAACAGAAG -> GATAGCGCCAAACAGAAGC
TGATAGGCAGGGCAATTTG -> GATAGGCAGGGCAATTTGT
TGATATCATTGTGACGGGT -> GATATCATTGTGACGGGTC
TGATCACGGGCTGTTGCTT -> GATCACGGGCTGTTGCTTA
TGCAAGCTAAACCCATATT -> GCAAGCTAAACCCATATTC
TGCAAGGCAGGCTTATGTC -> GCAAGGCAGGCTTATGTCT
TGCAAGTTCAATCAACGAG -> GCAAGTTCAATCAACGAGC
TGCAAGTTTCTCATTCTGT -> GCAAGTTTCTCATTCTGTG
TGCACACCTGTTCAACGAT -> GCACACCTGTTCAACGATT
TGCACCAGTTTGATACCAC -> GCACCAGTTTGATACCACT
TGCACCAGTTTGATAGCGC -> GCACCAGTTTGATAGCGCC
TGCACCAGTTTGATAGGCA -> GCACCAGTTTGATAGGCAG
TGCACCAGTTTGATATCAT -> GCACCAGTTTGATATCATT
TGCACGCGACCTAAGATCC -> GCACGCGACCTAAGATCCG
TGCAGAGTTCAATAAAAGG -> GCAGAGTTCAATAAAAGGT
TGCAGAGTTCAATCAGACT -> GCAGAGTTCAATCAGACTG
TGCAGAGTTCAATGGCTAG -> GCAGAGTTCAATGGCTAGC
TGCAGAGTTCAATTTCTCA -> GCAGAGTTCAATTTCTCAC
TGCATAGGAAAGAAAGTCA -> GCATAGGAAAGAAAGTCAG
TGCCACTAAGCTCCAAATA -> GCCACTAAGCTCCAAATAG
TGCCGTAGGGAGTATAGTA -> GCCGTAGGGAGTATAGTAT
TGCGACTGGCGTTCATGGT -> GCGACTGGCGTTCATGGTG
TGCGAGTTGTGGGGAGGTG -> GCGAGTTGTGGGGAGGTGG
TGCGGCGTTGCACCAGTTT -> GCGGCGTTGCACCAGTTTG
TGCGTCCAAATAGCTGTCA -> GCGTCCAAATAGCTGTCAT
TGCGTTGCACCAGTTTGAT -> GCGTTGCACCAGTTTGATA,GCGTTGCACCAGTTTGATA
TGCTACAGAAACCGAGTTC -> GCTACAGAAACCGAGTTCG
TGCTAGTTATAAGACCTTA -> GCTAGTTATAAGACCTTAT
TGCTCCACGGGGCCATTTT -> GCTCCACGGGGCCATTTTT
TGCTCCCACCGGATCCTGG -> GCTCCCACCGGATCCTGGT
TGCTCCTTCGCGTACATAA -> GCTCCTTCGCGTACATAAT
TGCTCGTCTCAATTCCTCA -> GCTCGTCTCAATTCCTCAA
TGCTGCATAGGAAAGAAAG -> GCTGCATAGGAAAGAAAGT
TGCTGGCACGGGGATGATA -> GCTGGCACGGGGATGATAA
TGCTTAGCTGCAGAGTTCA -> GCTTAGCTGCAGAGTTCAA
TGGACAAATCGACAATTTT -> GGACAAATCGACAATTTTC
TGGACAGAGAAACCGATCT -> GGACAGAGAAACCGATCTT
TGGACCGTATCGGCGGGCG -> GGACCGTATCGGCGGGCGA
TGGACGGGAGGACGTGAAC -> GGACGGGAGGACGTGAACC
TGGACTCTACAACGATCGT -> GGACTCTACAACGATCGTT
TGGAGCCTAAACAATCCGC -> GGAGCCTAAACAATCCGCT
TGGAGGCACGGCGTCCTAC -> GGAGGCACGGCGTCCTACT
TGGAGTGAGAGATTTGACC -> GGAGTGAGAGATTTGACCA
TGGATGTGGATGTTTCGAT -> GGATGTGGATGTTTCGATA
TGGATGTTTCGATAGCGCC -> GGATGTTTCGATAGCGCCC
TGGCACACGCAATGAGGCA -> GGCACACGCAATGAGGCAA
TGGCACGGGGATGATAATT -> GGCACGGGGATGATAATTG
TGGCACTGGACCGTATCGG -> GGCACTGGACCGTATCGGC
TGGCATTGCAAGGCAGGCT -> GGCATTGCAAGGCAGGCTT
TGGCCGATTGCGTCCAAAT -> GGCCGATTGCGTCCAAATA
TGGCCGTGATACGGAGTGG -> GGCCGTGATACGGAGTGGT
TGGCGCTGAGTTGAAGCCT -> GGCGCTGAGTTGAAGCCTT
TGGCGTTCATGGTGTTACT -> GGCGTTCATGGTGTTACTA
TGGCTACTAAAAATGGTAA -> GGCTACTAAAAATGGTAAG
TGGCTAGCTTCTGCGTTGC -> GGCTAGCTTCTGCGTTGCA
TGGCTCTAGTGTACGTGGG -> GGCTCTAGTGTACGTGGGT
TGGGAACAAGAAGAACTGA -> GGGAACAAGAAGAACTGAA
TGGGACCTTCCTGGCCGTG -> GGGACCTTCCTGGCCGTGA
TGGGATGGGAACAAGAAGA -> GGGATGGGAACAAGAAGAA
TGGGCACCTTCCGTACCGA -> GGGCACCTTCCGTACCGAC
TGGGGAGGTGGTCGGTTAA -> GGGGAGGTGGTCGGTTAAG
TGGGTAATTGGACTCTACA -> GGGTAATTGGACTCTACAA
TGGGTACTAGTTTTACAAT -> GGGTACTAGTTTTACAATT
TGGGTCCTCTACCTCAGCC -> GGGTCCTCTACCTCAGCCT
TGGGTGGAGGCACGGCGTC -> GGGTGGAGGCACGGCGTCC
TGGTAAGATTCTGTTATGT -> GGTAAGATTCTGTTATGTG
TGGTACTTTCGTGGCTCTA -> GGTACTTTCGTGGCTCTAG
TGGTATACGTCGGGTGCAA -> GGTATACGTCGGGTGCAAG
TGGTATCAACCAACCCATC -> GGTATCAACCAACCCATCA
TGGTCAGCATAACAGGTCA -> GGTCAGCATAACAGGTCAT
TGGTCAGCGGTGGGTCCTC -> GGTCAGCGGTGGGTCCTCT
TGGTCGGTTAAGTGAAAGT -> GGTCGGTTAAGTGAAAGTT
TGGTGAAGCGGTTTATTAA -> GGTGAAGCGGTTTATTAAG
TGGTGTTACTAGACTCCGA -> GGTGTTACTAGACTCCGAT
TGGTTAGCTGCAGAGTTCA -> GGTTAGCTGCAGAGTTCAA
TGGTTCGCCCATGGTCAGC -> GGTTCGCCCATGGTCAGCA
TGTACGTGGGTAATTGGAC -> GTACGTGGGTAATTGGACT
TGTATAAGCAGCTAGTAGA -> GTATAAGCAGCTAGTAGAT
TGTATGGGCACCTTCCGTA -> GTATGGGCACCTTCCGTAC
TGTCACTCATCGTGGATGT -> GTCACTCATCGTGGATGTG
TGTCATCATAGGAAAGAAA -> GTCATCATAGGAAAGAAAC
TGTCCTCCATCCTAACTAT -> GTCCTCCATCCTAACTATT
TGTCTAGCAACCAAGAAAA -> GTCTAGCAACCAAGAAAAC
TGTCTGAACGACCGGCGTA -> GTCTGAACGACCGGCGTAG
TGTGAAAGGGGTAGATTGC -> GTGAAAGGGGTAGATTGCC
TGTGAACATAAGCCGATTA -> GTGAACATAAGCCGATTAC
TGTGACACAGTTGGTTCGC -> GTGACACAGTTGGTTCGCC
TGTGACGGGTCTAGACGGT -> GTGACGGGTCTAGACGGTA
TGTGATACCGCGGAGGTAG -> GTGATACCGCGGAGGTAGA
TGTGGATGTTTCGATAGCG -> GTGGATGTTTCGATAGCGC
TGTGGCGCTGAGTTGAAGC -> GTGGCGCTGAGTTGAAGCC
TGTGGGGAGGTGGTCGGTT -> GTGGGGAGGTGGTCGGTTA
TGTGGGTACTAGTTTTACA -> GTGGGTACTAGTTTTACAA
TGTGTATGGGCACCTTCCG -> GTGTATGGGCACCTTCCGT
TGTTACGCCTTCTATAAAG -> GTTACGCCTTCTATAAAGC
TGTTACTAGACTCCGATCA -> GTTACTAGACTCCGATCAG
TGTTATGTGGGTACTAGTT -> GTTATGTGGGTACTAGTTT
TGTTCAACGATTTCCGAAT -> GTTCAACGATTTCCGAATA
TGTTCCCTCATTAGGAGTA -> GTTCCCTCATTAGGAGTAG
TGTTGCTTAGCTGCAGAGT -> GTTGCTTAGCTGCAGAGTT
TGTTTCGATAGCGCCCTGG -> GTTTCGATAGCGCCCTGGC
TGTTTTCGGGCTAACGGAA -> GTTTTCGGGCTAACGGAAG
TTAAGAGACAGGTTTGGTC -> TAAGAGACAGGTTTGGTCA
TTAAGCGTAGGTCCATTGA -> TAAGCGTAGGTCCATTGAC
TTAAGTGAAAGTTCTTAGC -> TAAGTGAAAGTTCTTAGCA
TTACAACCTCCGCGCGATG -> TACAACCTCCGCGCGATGT
TTACAATTCGCAGACACAG -> TACAATTCGCAGACACAGC
TTACCGCACCCTCGCGGTG -> TACCGCACCCTCGCGGTGT
TTACGCCTTCTATAAAGCC -> TACGCCTTCTATAAAGCCC
TTACGCTCGTTTGTTCCCT -> TACGCTCGTTTGTTCCCTC
TTACTAGACTCCGATCAGT -> TACTAGACTCCGATCAGTA
TTACTCATGTTACGCCTTC -> TACTCATGTTACGCCTTCT
TTACTCCCTCGGGTAACCG -> TACTCCCTCGGGTAACCGG
TTAGAAGTTGGGACCTTCC -> TAGAAGTTGGGACCTTCCT
TTAGACGATTGAAAGCAGT -> TAGACGATTGAAAGCAGTG
TTAGCAGGAATACGCTCAC -> TAGCAGGAATACGCTCACC
TTAGCCTAAGTCATGAGTT -> TAGCCTAAGTCATGAGTTA
TTAGCGCTGGCCGATTGCG -> TAGCGCTGGCCGATTGCGT
TTAGCTCATGTGGCGCTGA -> TAGCTCATGTGGCGCTGAG
TTAGCTGAAATCGCGCTCG -> TAGCTGAAATCGCGCTCGA
TTAGCTGCAGAGTTCAATA -> TAGCTGCAGAGTTCAATAA
TTAGCTGCAGAGTTCAATC -> TAGCTGCAGAGTTCAATCA
TTAGCTGCAGAGTTCAATG -> TAGCTGCAGAGTTCAATGG
TTAGCTGCAGAGTTCAATT -> TAGCTGCAGAGTTCAATTT
TTAGGAGTAGCCGCATATG -> TAGGAGTAGCCGCATATGG
TTAGGCGAAAAGTATGGTT -> TAGGCGAAAAGTATGGTTA
TTAGGGAAACCTGCTAGTT -> TAGGGAAACCTGCTAGTTA
TTAGTCTGAGTAAGTGCTG -> TAGTCTGAGTAAGTGCTGG
TTATAAGACCTTATGAGCG -> TATAAGACCTTATGAGCGT
TTATCCAGTTACAACCTCC -> TATCCAGTTACAACCTCCG
TTATGAGCGTAACGCAGGG -> TATGAGCGTAACGCAGGGA
TTATGGACGGGAGGACGTG -> TATGGACGGGAGGACGTGA
TTATGTATAAGCAGCTAGT -> TATGTATAAGCAGCTAGTA
TTATGTCTAGCAACCAAGA -> TATGTCTAGCAACCAAGAA
TTATGTGGGTACTAGTTTT -> TATGTGGGTACTAGTTTTA
TTATTAAGAGACAGGTTTG -> TATTAAGAGACAGGTTTGG
TTCAACGATTTCCGAATAA -> TCAACGATTTCCGAATAAT
TTCAATAAAAGGTTGCGGC -> TCAATAAAAGGTTGCGGCG
TTCAATCAACGAGCCAGGC -> TCAATCAACGAGCCAGGCT
TTCAATCAGACTGAAACGC -> TCAATCAGACTGAAACGCG
TTCAATGGCTAGCTTCTGC -> TCAATGGCTAGCTTCTGCG
TTCAATTTCTCACGGATGC -> TCAATTTCTCACGGATGCG
TTCACCATTCATACGTGAA -> TCACCATTCATACGTGAAT
TTCATACGTGAATGCACGC -> TCATACGTGAATGCACGCG
TTCATGGTGTTACTAGACT -> TCATGGTGTTACTAGACTC
TTCCCGCGCTTGTGTATGG -> TCCCGCGCTTGTGTATGGG
TTCCCTCATTAGGAGTAGC -> TCCCTCATTAGGAGTAGCC
TTCCGAATAATAGTGATCA -> TCCGAATAATAGTGATCAC
TTCCGCATAAGCAAGGAGA -> TCCGCATAAGCAAGGAGAC
TTCCGTACCGACCAGGGGT -> TCCGTACCGACCAGGGGTA
TTCCTCAAGTGGTACTTTC -> TCCTCAAGTGGTACTTTCG
TTCCTGGCCGTGATACGGA -> TCCTGGCCGTGATACGGAG
TTCCTTTCGAGGCATTACC -> TCCTTTCGAGGCATTACCG
TTCGACCAATAACCTAGCT -> TCGACCAATAACCTAGCTT
TTCGAGGCATTACCGCACC -> TCGAGGCATTACCGCACCC
TTCGATAGCGCCCTGGCAC -> TCGATAGCGCCCTGGCACT
TTCGCAGACACAGCGTCGT -> TCGCAGACACAGCGTCGTG
TTCGCCCATGGTCAGCATA -> TCGCCCATGGTCAGCATAA
TTCGCGATTGCAAGCTAAA -> TCGCGATTGCAAGCTAAAC
TTCGCGTACATAATGGCAT -> TCGCGTACATAATGGCATT
TTCGCGTCCATGCGAGTTG -> TCGCGTCCATGCGAGTTGT
TTCGGACGGATTAGGCGAA -> TCGGACGGATTAGGCGAAA
TTCGGGCTAACGGAAGGTT -> TCGGGCTAACGGAAGGTTT
TTCGTGGCTCTAGTGTACG -> TCGTGGCTCTAGTGTACGT
TTCGTGGTGAAGCGGTTTA -> TCGTGGTGAAGCGGTTTAT
TTCTACAAAACGTTAGAAG -> TCTACAAAACGTTAGAAGT
TTCTATAAAGCCCCCGCGG -> TCTATAAAGCCCCCGCGGC
TTCTCACGGATGCGTTGCA -> TCTCACGGATGCGTTGCAC
TTCTCATTCTGTGATACCG -> TCTCATTCTGTGATACCGC
TTCTCGTGCTACAGAAACC -> TCTCGTGCTACAGAAACCG
TTCTGCGTTGCACCAGTTT -> TCTGCGTTGCACCAGTTTG
TTCTGTGATACCGCGGAGG -> TCTGTGATACCGCGGAGGT
TTCTGTTATGTGGGTACTA -> TCTGTTATGTGGGTACTAG
TTCTTAGCAGGAATACGCT -> TCTTAGCAGGAATACGCTC
TTCTTTAGCTCATGTGGCG -> TCTTTAGCTCATGTGGCGC
TTGAAAGCAGTGAGATCAC -> TGAAAGCAGTGAGATCACG
TTGAAAGGGGGAGATATAT -> TGAAAGGGGGAGATATATA
TTGAAGCCTTCGACCAATA -> TGAAGCCTTCGACCAATAA
TTGACAAATTGTCTGAACG -> TGACAAATTGTCTGAACGA
TTGACACTCGTTAGGGAAA -> TGACACTCGTTAGGGAAAC
TTGACCACCCAACAGGCGT -> TGACCACCCAACAGGCGTG
TTGATACCACTTTCCGCAT -> TGATACCACTTTCCGCATA
TTGATAGCGCCAAACAGAA -> TGATAGCGCCAAACAGAAG
TTGATAGGCAGGGCAATTT -> TGATAGGCAGGGCAATTTG
TTGATATCATTGTGACGGG -> TGATATCATTGTGACGGGT
TTGCAAGCTAAACCCATAT -> TGCAAGCTAAACCCATATT
TTGCAAGGCAGGCTTATGT -> TGCAAGGCAGGCTTATGTC
TTGCACCAGTTTGATACCA -> TGCACCAGTTTGATACCAC
TTGCACCAGTTTGATAGCG -> TGCACCAGTTTGATAGCGC
TTGCACCAGTTTGATAGGC -> TGCACCAGTTTGATAGGCA
TTGCACCAGTTTGATATCA -> TGCACCAGTTTGATATCAT
TTGCCGTAGGGAGTATAGT -> TGCCGTAGGGAGTATAGTA
TTGCGGCGTTGCACCAGTT -> TGCGGCGTTGCACCAGTTT
TTGCGTCCAAATAGCTGTC -> TGCGTCCAAATAGCTGTCA
TTGCTTAGCTGCAGAGTTC -> TGCTTAGCTGCAGAGTTCA
TTGGACTCTACAACGATCG -> TGGACTCTACAACGATCGT
TTGGAGTGAGAGATTTGAC -> TGGAGTGAGAGATTTGACC
TTGGGACCTTCCTGGCCGT -> TGGGACCTTCCTGGCCGTG
TTGGGATGGGAACAAGAAG -> TGGGATGGGAACAAGAAGA
TTGGTCAGCGGTGGGTCCT -> TGGTCAGCGGTGGGTCCTC
TTGGTTCGCCCATGGTCAG -> TGGTTCGCCCATGGTCAGC
TTGTCCTCCATCCTAACTA -> TGTCCTCCATCCTAACTAT
TTGTCTGAACGACCGGCGT -> TGTCTGAACGACCGGCGTA
TTGTGACGGGTCTAGACGG -> TGTGACGGGTCTAGACGGT
TTGTGGGGAGGTGGTCGGT -> TGTGGGGAGGTGGTCGGTT
TTGTGTATGGGCACCTTCC -> TGTGTATGGGCACCTTCCG
TTGTTCCCTCATTAGGAGT -> TGTTCCCTCATTAGGAGTA
TTTAAGCGTAGGTCCATTG -> TTAAGCGTAGGTCCATTGA
TTTACAATTCGCAGACACA -> TTACAATTCGCAGACACAG
TTTACGCTCGTTTGTTCCC -> TTACGCTCGTTTGTTCCCT
TTTACTCATGTTACGCCTT -> TTACTCATGTTACGCCTTC
TTTAGCTCATGTGGCGCTG -> TTAGCTCATGTGGCGCTGA
TTTAGCTGCAGAGTTCAAT -> TTAGCTGCAGAGTTCAATT
TTTAGTCTGAGTAAGTGCT -> TTAGTCTGAGTAAGTGCTG
TTTATTAAGAGACAGGTTT -> TTATTAAGAGACAGGTTTG
TTTCCCGCGCTTGTGTATG -> TTCCCGCGCTTGTGTATGG
TTTCCGAATAATAGTGATC -> TTCCGAATAATAGTGATCA
TTTCCGCATAAGCAAGGAG -> TTCCGCATAAGCAAGGAGA
TTTCGAGGCATTACCGCAC -> TTCGAGGCATTACCGCACC
TTTCGATAGCGCCCTGGCA -> TTCGATAGCGCCCTGGCAC
TTTCGGACGGATTAGGCGA -> TTCGGACGGATTAGGCGAA
TTTCGGGCTAACGGAAGGT -> TTCGGGCTAACGGAAGGTT
TTTCGTGGCTCTAGTGTAC -> TTCGTGGCTCTAGTGTACG
TTTCTCACGGATGCGTTGC -> TTCTCACGGATGCGTTGCA
TTTCTCATTCTGTGATACC -> TTCTCATTCTGTGATACCG
TTTCTTTAGCTCATGTGGC -> TTCTTTAGCTCATGTGGCG
TTTGAAAGGGGGAGATATA -> TTGAAAGGGGGAGATATAT
TTTGACCACCCAACAGGCG -> TTGACCACCCAACAGGCGT
TTTGATACCACTTTCCGCA -> TTGATACCACTTTCCGCAT
TTTGATAGCGCCAAACAGA -> TTGATAGCGCCAAACAGAA
TTTGATAGGCAGGGCAATT -> TTGATAGGCAGGGCAATTT
TTTGATATCATTGTGACGG -> TTGATATCATTGTGACGGG
TTTGGTCAGCGGTGGGTCC -> TTGGTCAGCGGTGGGTCCT
TTTGTCCTCCATCCTAACT -> TTGTCCTCCATCCTAACTA
TTTGTTCCCTCATTAGGAG -> TTGTTCCCTCATTAGGAGT
TTTTACAATTCGCAGACAC -> TTTACAATTCGCAGACACA
TTTTACGCTCGTTTGTTCC -> TTTACGCTCGTTTGTTCCC
TTTTAGTCTGAGTAAGTGC -> TTTAGTCTGAGTAAGTGCT
TTTTCCCGCGCTTGTGTAT -> TTTCCCGCGCTTGTGTATG
TTTTCGGACGGATTAGGCG -> TTTCGGACGGATTAGGCGA
TTTTCGGGCTAACGGAAGG -> TTTCGGGCTAACGGAAGGT
TTTTTACGCTCGTTTGTTC -> TTTTACGCTCGTTTGTTCC
TTTTTAGTCTGAGTAAGTG -> TTTTAGTCTGAGTAAGTGC
TTTTTCCCGCGCTTGTGTA -> TTTTCCCGCGCTTGTGTAT
TTTTTTACGCTCGTTTGTT -> TTTTTACGCTCGTTTGTTC
TTTTTTTACGCTCGTTTGT -> TTTTTTACGCTCGTTTGTT
